Brown-Kunde	Function-based uniform algorithm	User-centric bandwidth-monitored matrices
Homenick LLC	De-engineered national implementation	Extended responsive time-frame
Green-Tillman	Networked 4th generation service-desk	Vision-oriented multimedia functionalities
O'Hara, Conroy and Schmeler	Progressive global infrastructure	Extended 24 hour intranet
Sawayn Inc	Front-line full-range success	Devolved non-volatile toolset
McGlynn LLC	Devolved zero administration encryption	Object-based directional throughput
Marquardt and Sons	Future-proofed zero defect architecture	Reduced 4th generation strategy
Abernathy Inc	Horizontal full-range utilisation	Assimilated mission-critical emulation
Schumm-Metz	Synergistic exuding portal	Distributed assymetric solution
Stokes Group	Organized tertiary orchestration	Enterprise-wide attitude-oriented model
Zulauf Group	Diverse discrete process improvement	Progressive directional forecast
Weimann-D'Amore	Diverse static complexity	Extended user-facing open system
Kris-Kemmer	Fully-configurable neutral artificial intelligence	Digitized static support
Wehner, Schaefer and McKenzie	Reduced optimizing data-warehouse	Face to face high-level initiative
Predovic-Wisozk	Fully-configurable client-driven application	Triple-buffered bi-directional workforce
Nikolaus, Von and Smith	Operative content-based architecture	Cross-platform bifurcated groupware
McCullough-Cruickshank	Realigned dynamic moderator	Switchable scalable flexibility
Strosin-Kuvalis	Persistent interactive definition	Universal high-level collaboration
Dach-Krajcik	Self-enabling stable productivity	Profound tertiary model
Gutmann, Terry and Grant	Optional analyzing workforce	Universal optimal functionalities
Gottlieb LLC	Extended asynchronous intranet	Open-source client-driven hierarchy
Mosciski Group	Fully-configurable multi-tasking capacity	Customer-focused foreground methodology
Blick LLC	Polarised system-worthy website	Seamless hybrid analyzer
Lueilwitz-Yost	Customer-focused assymetric infrastructure	Operative client-driven portal
Gottlieb-Cronin	Vision-oriented zero tolerance attitude	Optional executive secured line
Stroman, Rodriguez and Erdman	Monitored stable toolset	Inverse client-server application
Rogahn-Okuneva	Fundamental 5th generation circuit	Seamless grid-enabled complexity
Dicki and Sons	Function-based holistic conglomeration	Progressive tangible structure
Smith and Sons	Stand-alone multimedia software	Assimilated optimal paradigm
Hermiston LLC	Universal demand-driven encoding	Profit-focused 24/7 challenge
Hauck-Sporer	Integrated systemic complexity	Managed homogeneous archive
Kassulke, Morissette and Satterfield	Multi-layered dedicated software	Customizable 6th generation toolset
Rohan, Wilkinson and Bayer	Intuitive multi-state installation	Realigned asynchronous analyzer
Hammes-Mohr	Cloned analyzing task-force	Virtual responsive monitoring
Robel, Brekke and Fisher	Multi-channelled eco-centric complexity	Centralized 24 hour function
Blanda and Sons	Horizontal global conglomeration	Team-oriented coherent synergy
Orn Inc	Automated didactic paradigm	Mandatory clear-thinking adapter
Weissnat Inc	Multi-lateral local initiative	Versatile methodical adapter
Reichert-Adams	Seamless empowering hierarchy	Front-line background extranet
Osinski Group	Multi-lateral impactful time-frame	User-centric dynamic challenge
Zboncak LLC	Vision-oriented secondary data-warehouse	Reactive exuding array
Jacobi LLC	Synergized web-enabled focus group	Stand-alone content-based standardization
Schuster and Sons	Front-line 24 hour throughput	Multi-lateral value-added challenge
Swift-Shields	Reduced discrete migration	Function-based clear-thinking customer loyalty
Gutkowski-Wyman	Organic homogeneous capability	De-engineered coherent policy
Ledner and Sons	Secured full-range Graphical User Interface	Persevering optimal leverage
Jast, Kutch and Rohan	Enhanced dynamic concept	Synergized heuristic utilisation
Schamberger and Sons	Exclusive national analyzer	Pre-emptive solution-oriented methodology
Stroman, Mosciski and Luettgen	Profound even-keeled artificial intelligence	Up-sized uniform access
Kub-Jakubowski	Enterprise-wide reciprocal instruction set	Inverse multi-state artificial intelligence
Turcotte LLC	Face to face national Graphical User Interface	Organized modular access
Schaden and Sons	Integrated logistical complexity	Sharable logistical orchestration
Wolf Inc	Decentralized modular protocol	Cross-platform full-range local area network
Mayert-King	Universal stable orchestration	Monitored static software
Wintheiser, Auer and Hodkiewicz	Re-engineered system-worthy encoding	Public-key cohesive hub
Harris, Dicki and Grant	Enterprise-wide value-added pricing structure	Ameliorated local challenge
Langworth, Moore and Boyle	Reverse-engineered uniform software	Optional motivating data-warehouse
Predovic-Jenkins	Digitized national pricing structure	Versatile empowering policy
Harber LLC	Centralized didactic alliance	Realigned bifurcated artificial intelligence
Smith, Hoeger and Kiehn	Down-sized value-added pricing structure	Implemented homogeneous capacity
Rowe, Lemke and Ankunding	Fully-configurable bi-directional software	Focused disintermediate system engine
Harvey-Bednar	Organic empowering paradigm	Robust next generation solution
Effertz-Donnelly	Distributed 24/7 capability	Self-enabling 24 hour analyzer
Gerhold-Mayert	Cross-group systematic circuit	Secured radical superstructure
Watsica, Cruickshank and Ebert	Digitized explicit core	Enhanced uniform parallelism
Rath and Sons	Polarised multimedia encryption	Visionary client-server synergy
Kirlin-Gibson	Profit-focused high-level intranet	Polarised didactic encryption
Denesik Inc	Customizable multi-tasking ability	Profit-focused neutral hub
Morar-Abshire	Synergized content-based function	Multi-tiered bi-directional toolset
Moore, Daugherty and Ullrich	Universal bandwidth-monitored circuit	Business-focused intangible synergy
Hamill, Schmeler and Schmitt	Devolved hybrid matrix	Diverse assymetric access
Lemke-Nolan	Assimilated leading edge function	Phased impactful system engine
Goyette-O'Kon	Focused actuating website	Polarised zero administration budgetary management
Johns Inc	Inverse analyzing instruction set	Programmable impactful task-force
Feest, Jaskolski and O'Conner	Horizontal grid-enabled standardization	Persistent dedicated info-mediaries
Sauer-Weimann	Exclusive foreground workforce	Virtual uniform flexibility
Howell Group	Cross-platform holistic matrix	Expanded executive forecast
O'Kon, Bernier and Gusikowski	Optimized scalable forecast	Exclusive bifurcated customer loyalty
Kuhic, Veum and Wilkinson	Cross-platform 24 hour open architecture	Streamlined reciprocal internet solution
Sanford, Bradtke and Emard	Optimized reciprocal database	Horizontal bifurcated extranet
Boehm-Kertzmann	Configurable upward-trending orchestration	Programmable reciprocal installation
Hills-Dare	Universal analyzing installation	Exclusive heuristic utilisation
Osinski-Kozey	Balanced cohesive local area network	Seamless cohesive moratorium
Beatty and Sons	Reverse-engineered systemic analyzer	Persistent mobile collaboration
Parker-Veum	Re-engineered context-sensitive budgetary management	Robust 4th generation superstructure
Kihn-Wuckert	Reactive radical neural-net	Adaptive dedicated parallelism
Dicki and Sons	Quality-focused dynamic conglomeration	Persevering clear-thinking interface
Hilpert LLC	Robust assymetric forecast	Devolved systemic implementation
Harris, Batz and O'Kon	Operative national protocol	Organic human-resource budgetary management
Thiel-Frami	Monitored global instruction set	Re-contextualized mission-critical encryption
Sawayn-Baumbach	Face to face reciprocal forecast	Mandatory reciprocal task-force
Marks-Schuppe	Sharable hybrid customer loyalty	Public-key maximized core
Lind-Schuppe	Optional tertiary parallelism	User-centric motivating superstructure
Herman Inc	Re-contextualized well-modulated open architecture	Optional disintermediate synergy
Maggio, Skiles and Schaefer	Profound intermediate attitude	Multi-tiered client-server policy
Bergstrom, Schaefer and Marquardt	Object-based bandwidth-monitored open architecture	Mandatory disintermediate info-mediaries
Ward-Lang	User-friendly discrete Graphic Interface	Synergistic global contingency
Vandervort, Balistreri and Price	Open-source bandwidth-monitored matrices	Networked heuristic algorithm
Wisoky Inc	Persistent solution-oriented moderator	Proactive disintermediate orchestration
Hudson, Orn and Bartell	Re-contextualized client-server algorithm	Advanced incremental internet solution
Fritsch Inc	Devolved optimal budgetary management	Reverse-engineered holistic framework
Hudson, Mertz and Terry	Team-oriented object-oriented software	Multi-lateral full-range infrastructure
Hauck, Gislason and Oberbrunner	Realigned global productivity	Down-sized value-added orchestration
Bartoletti, Collins and Keebler	Persevering explicit budgetary management	Up-sized logistical complexity
Zboncak Inc	Innovative local help-desk	Organic value-added customer loyalty
Hauck Group	Synchronised zero defect Graphic Interface	Ameliorated 5th generation functionalities
Ankunding-Lowe	Versatile system-worthy initiative	Seamless cohesive emulation
Bosco, Haag and Hauck	Open-source exuding help-desk	Open-source radical initiative
Quitzon Inc	Reverse-engineered bi-directional focus group	Quality-focused optimizing architecture
Greenfelder-Koelpin	Assimilated neutral emulation	Decentralized empowering website
Kunde-Jast	Focused 6th generation orchestration	User-friendly methodical emulation
Jacobs-Rutherford	Robust clear-thinking help-desk	Customizable reciprocal artificial intelligence
Schneider Group	Seamless radical strategy	Future-proofed value-added customer loyalty
Williamson-Haag	Mandatory solution-oriented productivity	Open-architected upward-trending time-frame
Quigley-Schaden	Front-line fault-tolerant model	Devolved explicit migration
Daugherty, Langosh and Kerluke	Multi-tiered homogeneous time-frame	Persistent dedicated parallelism
Gislason Inc	Secured bandwidth-monitored strategy	Multi-tiered object-oriented encryption
Schmeler and Sons	Customizable systemic pricing structure	Ergonomic attitude-oriented infrastructure
Larkin-O'Kon	Focused explicit open architecture	Reverse-engineered zero defect encryption
Wunsch Group	Total needs-based conglomeration	Proactive 6th generation collaboration
Kohler LLC	Optimized optimizing process improvement	Extended optimizing info-mediaries
Padberg, Tremblay and Sipes	Face to face discrete initiative	Innovative 5th generation array
Rogahn-Dietrich	Optimized national hub	Front-line systemic service-desk
Effertz, Raynor and Turcotte	Progressive background structure	Streamlined grid-enabled extranet
Hermiston-Labadie	Re-contextualized background standardization	Reverse-engineered bi-directional data-warehouse
Kunze, Monahan and Kertzmann	Managed assymetric orchestration	Ameliorated zero administration concept
Abernathy-Rogahn	Upgradable interactive secured line	User-friendly scalable hardware
Braun-Batz	Pre-emptive 5th generation encoding	Multi-layered multimedia emulation
Smitham LLC	User-friendly value-added algorithm	Streamlined human-resource standardization
Runte, Bins and Beatty	Re-engineered object-oriented infrastructure	Virtual 5th generation array
Konopelski Group	Diverse bandwidth-monitored solution	Object-based 6th generation help-desk
Wilkinson-Gislason	Extended foreground success	Sharable multi-tasking application
Hartmann-King	Distributed contextually-based website	Diverse client-driven hardware
Koch-Zemlak	Configurable multi-tasking alliance	Ameliorated global encoding
Smith, Block and Beatty	Face to face scalable definition	De-engineered executive help-desk
Conn, Mayer and Wiza	Adaptive client-driven support	Persevering bandwidth-monitored initiative
Lockman, Raynor and Herzog	Synergized upward-trending task-force	Realigned directional access
Champlin-Armstrong	Secured motivating initiative	Cross-group tertiary encoding
Dietrich-Smitham	Polarised intangible Graphic Interface	Switchable next generation Graphic Interface
Wilkinson Group	Grass-roots local policy	Synergized modular project
Fritsch, Runolfsson and Hartmann	Cross-group demand-driven emulation	Re-engineered context-sensitive workforce
Stanton, Turner and Hauck	Multi-layered needs-based process improvement	Front-line systematic time-frame
Stark, Haag and Walter	User-centric client-server capability	Networked secondary project
Mante LLC	Object-based grid-enabled infrastructure	Profound user-facing encryption
Hirthe-Hoeger	Expanded multimedia neural-net	Progressive 3rd generation synergy
Fritsch, Christiansen and Kertzmann	Team-oriented modular standardization	Implemented systemic frame
Herzog-Wolff	Function-based composite policy	Innovative system-worthy circuit
Walker LLC	Intuitive fault-tolerant synergy	Stand-alone systematic challenge
Windler Group	Reduced secondary benchmark	Progressive upward-trending orchestration
Kozey-Mills	Triple-buffered holistic capability	Multi-channelled multi-tasking workforce
Thompson, Ziemann and Lockman	Realigned assymetric utilisation	Total disintermediate utilisation
Jerde, Waters and Gottlieb	Organic systemic customer loyalty	Function-based mission-critical infrastructure
Hauck Group	Customizable responsive migration	Optimized optimizing budgetary management
Gislason, Kovacek and Padberg	Intuitive attitude-oriented attitude	Realigned grid-enabled synergy
Boehm LLC	Virtual clear-thinking moderator	Streamlined contextually-based solution
Halvorson, Pacocha and Bednar	Centralized background product	Open-architected 24 hour Graphical User Interface
Gleason LLC	Configurable context-sensitive architecture	Vision-oriented mission-critical benchmark
Pagac, Langworth and Corkery	Advanced leading edge local area network	Centralized intangible capability
Frami Group	Down-sized needs-based hierarchy	Configurable stable system engine
Bauch LLC	Optimized local definition	Multi-layered content-based benchmark
Beier, Bauch and Cruickshank	Secured cohesive migration	Ameliorated human-resource secured line
Walter-Pollich	Reactive intangible data-warehouse	Multi-channelled secondary matrices
Schmidt and Sons	Multi-lateral zero defect utilisation	Right-sized content-based core
Walter and Sons	Exclusive uniform help-desk	Persistent optimal hub
Rodriguez-Grimes	Ameliorated empowering flexibility	Multi-lateral zero administration orchestration
Lynch-Conroy	Networked demand-driven budgetary management	Universal responsive paradigm
Wilkinson Inc	Intuitive logistical moderator	Adaptive cohesive pricing structure
Quitzon Group	Open-architected web-enabled utilisation	Integrated methodical website
Gottlieb Inc	Polarised composite knowledge user	Monitored heuristic utilisation
Dare, Howe and White	Monitored homogeneous database	Integrated holistic matrix
Gibson-Kling	Visionary attitude-oriented contingency	Re-engineered web-enabled leverage
Lowe, Reinger and Daniel	Fully-configurable 24/7 toolset	Sharable uniform open architecture
Pagac-Kunde	Networked transitional archive	Sharable user-facing knowledge user
Lynch Inc	Diverse didactic collaboration	Future-proofed intermediate data-warehouse
VonRueden-O'Hara	Vision-oriented systemic architecture	Centralized methodical parallelism
Johnson, Waelchi and Volkman	Seamless exuding initiative	Managed 3rd generation protocol
Farrell, Swaniawski and Pacocha	De-engineered interactive hierarchy	Open-source full-range parallelism
Purdy, Crona and Walker	Realigned dedicated conglomeration	Total systemic array
Dach, Beatty and Parker	Persevering even-keeled artificial intelligence	Automated responsive policy
Nikolaus and Sons	Exclusive intangible project	Robust global open system
Wyman Group	Synchronised dynamic capability	Ameliorated motivating paradigm
Hills Inc	Right-sized upward-trending ability	Inverse systemic service-desk
Morar, O'Hara and Schowalter	Pre-emptive content-based solution	Cross-platform actuating model
Botsford-Turcotte	Persistent optimizing project	Persistent attitude-oriented productivity
Schamberger, Collier and Kuvalis	Managed regional circuit	Digitized regional access
Weissnat, Sanford and Yundt	Centralized disintermediate secured line	Decentralized stable knowledge user
Lang-Fadel	Upgradable responsive approach	Re-contextualized demand-driven flexibility
Braun, Oberbrunner and Hagenes	Customizable needs-based local area network	Customizable solution-oriented help-desk
Cummerata Group	Horizontal explicit capacity	Re-engineered bandwidth-monitored forecast
Swaniawski-Weimann	Centralized discrete info-mediaries	Monitored motivating intranet
Bechtelar-Sanford	Fundamental well-modulated algorithm	Inverse interactive throughput
Hegmann, Weimann and Ruecker	Progressive homogeneous system engine	Right-sized dedicated projection
Harber Group	Open-architected system-worthy open architecture	Reactive radical analyzer
Rau LLC	Synergistic exuding interface	Digitized attitude-oriented contingency
Purdy Inc	Function-based 24/7 website	Enhanced 5th generation product
Klein, Hammes and Considine	Decentralized system-worthy concept	Diverse transitional task-force
Strosin-Bartoletti	Public-key scalable attitude	Visionary bi-directional function
Altenwerth, Carter and Schowalter	Re-engineered bottom-line frame	Horizontal responsive analyzer
Vandervort-Friesen	Virtual zero defect emulation	Horizontal eco-centric artificial intelligence
Pagac-Dibbert	Automated actuating challenge	Front-line fault-tolerant methodology
Wilkinson, Hamill and Johnson	Horizontal regional core	Exclusive methodical extranet
Tromp, Green and Gleason	Horizontal assymetric installation	Synchronised transitional extranet
Morissette-Nikolaus	Function-based didactic contingency	Sharable object-oriented Graphic Interface
Turcotte Group	Cloned local approach	Profound cohesive moderator
Hessel, Kerluke and Ratke	Intuitive holistic task-force	Realigned solution-oriented framework
Hackett Group	Face to face maximized paradigm	Focused demand-driven access
Labadie-Gusikowski	Robust object-oriented encryption	Up-sized neutral success
Wintheiser Inc	Horizontal tertiary model	Implemented explicit process improvement
Botsford-Bernhard	Universal fault-tolerant portal	Profit-focused bottom-line concept
Braun, Deckow and Bergnaum	Vision-oriented system-worthy policy	Vision-oriented static attitude
Dach-Runolfsdottir	Polarised maximized project	Focused composite attitude
Schmitt, Ullrich and Dicki	Cloned 24 hour process improvement	Synergistic bandwidth-monitored architecture
Krajcik, Wiza and Will	Multi-lateral global attitude	Seamless tertiary strategy
Lowe-Jakubowski	Customer-focused discrete moratorium	Synchronised discrete solution
Schaden-Ferry	Innovative radical standardization	Decentralized scalable neural-net
Stoltenberg, Lakin and Olson	Cross-platform stable solution	Upgradable modular encoding
Adams LLC	Persistent impactful hierarchy	Multi-tiered discrete matrices
Ebert and Sons	Virtual value-added approach	Ameliorated 4th generation circuit
Lebsack-Runolfsdottir	Customizable heuristic matrix	Profit-focused client-server alliance
Larson, Olson and Kihn	Reverse-engineered dynamic model	Centralized coherent encoding
Bailey-Graham	Multi-lateral human-resource functionalities	User-centric background knowledge user
Lebsack-Wolff	Versatile bifurcated capacity	Synchronised directional encryption
Kuhic-DuBuque	Realigned bifurcated initiative	Cloned interactive archive
Becker, Barton and Yost	Cloned radical solution	Cross-group object-oriented pricing structure
Russel, Heller and Marquardt	Customizable zero defect challenge	Focused systematic product
Homenick, Hodkiewicz and McKenzie	Operative fault-tolerant middleware	Exclusive methodical monitoring
Pollich Group	Secured empowering structure	Advanced 24 hour instruction set
Nolan-Waters	Robust bottom-line ability	Managed upward-trending projection
Jones Inc	De-engineered intangible open architecture	Phased zero administration flexibility
Stracke-Wuckert	Front-line optimizing attitude	Phased context-sensitive portal
Aufderhar-Franecki	Organized eco-centric portal	Triple-buffered uniform matrix
Lemke, Hauck and Casper	Stand-alone homogeneous intranet	Devolved human-resource matrix
Cole-Nikolaus	Open-architected context-sensitive process improvement	Profound bottom-line open architecture
Kreiger, Schmeler and Yost	Realigned composite archive	Extended demand-driven system engine
Champlin, Mosciski and Kling	Expanded grid-enabled toolset	Progressive executive flexibility
Pfeffer, Mante and Medhurst	Secured solution-oriented encryption	Fully-configurable human-resource extranet
Gaylord, Graham and Kuhlman	Re-engineered 3rd generation local area network	Re-contextualized web-enabled benchmark
Fadel-Wilkinson	Business-focused bifurcated access	Up-sized web-enabled leverage
Lind, Hyatt and Sawayn	Right-sized eco-centric data-warehouse	Digitized full-range paradigm
Prosacco, Wilderman and Haley	Organic object-oriented policy	Self-enabling system-worthy instruction set
Moore-Prosacco	Cloned maximized system engine	Proactive value-added initiative
Goyette Inc	Reduced optimal framework	Distributed neutral conglomeration
Schmidt-Grady	User-friendly global forecast	Multi-layered high-level function
Gislason-Zemlak	Streamlined demand-driven Graphical User Interface	Extended human-resource encoding
Lind, Maggio and Blick	Digitized homogeneous knowledge base	Fundamental composite help-desk
Ward, Rau and Volkman	Synergized dynamic access	Centralized grid-enabled infrastructure
Powlowski-Upton	Open-architected systematic forecast	Balanced transitional projection
Mante Inc	Phased multi-tasking focus group	Up-sized methodical model
McDermott Inc	Configurable bi-directional installation	Open-source incremental support
Rice LLC	Automated impactful collaboration	Fundamental 24 hour projection
Wehner, Koelpin and Leannon	Reactive contextually-based flexibility	Down-sized upward-trending conglomeration
O'Conner, Christiansen and Spinka	Realigned tertiary data-warehouse	Sharable stable emulation
Emard, Nikolaus and Rosenbaum	Polarised holistic array	Profit-focused zero defect architecture
Moen-Kling	Enterprise-wide hybrid functionalities	Multi-lateral optimal hub
Toy-Larson	Up-sized radical firmware	Profit-focused static standardization
Mueller-Bosco	Innovative solution-oriented challenge	Business-focused coherent neural-net
Effertz LLC	De-engineered holistic hub	Phased client-server adapter
Berge-Runte	Focused explicit neural-net	Organic bifurcated conglomeration
Kozey, Yost and Borer	Implemented systemic open architecture	Balanced context-sensitive methodology
Bartell-Kerluke	Multi-layered background framework	Mandatory 3rd generation analyzer
Kirlin and Sons	Realigned homogeneous architecture	Business-focused heuristic model
Bogan-Runolfsson	Devolved 5th generation model	Quality-focused disintermediate hub
Beahan, Stracke and Braun	Object-based optimal pricing structure	Enhanced dedicated portal
Quigley and Sons	Devolved dynamic methodology	Monitored multi-state structure
Lemke, Lebsack and Brakus	Optional attitude-oriented database	Persevering heuristic access
Lebsack, Wintheiser and Tremblay	Visionary full-range adapter	Right-sized incremental open system
Daniel, Jones and Frami	Devolved radical local area network	Multi-layered mobile system engine
Wuckert-Langosh	Cloned logistical algorithm	Team-oriented attitude-oriented implementation
Strosin Group	Profit-focused multi-tasking groupware	Profound leading edge hub
Greenholt, Ondricka and Glover	Advanced secondary solution	Expanded methodical structure
Beier-Spencer	Reactive 4th generation core	Triple-buffered context-sensitive moratorium
Hintz LLC	Fundamental holistic parallelism	Horizontal scalable matrix
Friesen Group	Multi-channelled composite time-frame	Advanced 4th generation middleware
Lakin Inc	Object-based disintermediate policy	Enhanced national application
Cummings-Wyman	Virtual assymetric array	Vision-oriented 5th generation info-mediaries
Ledner Group	User-friendly optimal challenge	Customer-focused demand-driven matrices
Bradtke Inc	Secured stable knowledge user	Team-oriented next generation framework
Grady LLC	Synergistic explicit benchmark	Persistent bandwidth-monitored leverage
Stehr Group	Organic object-oriented paradigm	Innovative optimal extranet
Johnston-Krajcik	Sharable dedicated model	Secured tertiary benchmark
Smitham, Sipes and Boyle	Versatile maximized matrix	Synergistic systematic toolset
Cartwright and Sons	Re-engineered holistic infrastructure	Exclusive multi-state moderator
Moore Inc	Multi-lateral maximized core	Down-sized web-enabled definition
Donnelly, Fadel and Considine	Stand-alone leading edge complexity	Business-focused optimizing support
Blanda-Romaguera	Cross-group object-oriented infrastructure	Multi-layered secondary initiative
Kris Inc	Down-sized foreground artificial intelligence	Future-proofed explicit local area network
Stiedemann-Hagenes	Exclusive global product	Visionary analyzing capacity
Stanton and Sons	Virtual clear-thinking pricing structure	Secured global paradigm
Kovacek and Sons	Assimilated homogeneous access	Multi-tiered bi-directional success
Leuschke Group	Devolved incremental help-desk	Inverse mission-critical architecture
Pfannerstill, Green and Schimmel	Polarised dynamic model	Open-architected reciprocal protocol
Olson LLC	Synchronised dynamic groupware	Programmable zero defect toolset
Hand, Prohaska and Turcotte	Expanded needs-based groupware	Triple-buffered zero administration attitude
Rice-Littel	Horizontal client-driven algorithm	Quality-focused transitional success
Lubowitz, Boyer and Satterfield	Implemented radical adapter	Inverse real-time customer loyalty
Rolfson LLC	Extended maximized core	Multi-layered bottom-line instruction set
Will Inc	Reverse-engineered responsive encryption	Business-focused logistical framework
Ebert, Stehr and Price	Centralized dynamic orchestration	Persevering tangible ability
Hauck, Harber and Pfannerstill	Compatible methodical artificial intelligence	Upgradable incremental matrices
Leuschke-DuBuque	Focused discrete methodology	Visionary stable functionalities
Kohler, Kuvalis and Gutmann	Stand-alone 24 hour throughput	Polarised encompassing leverage
Schaefer, Schmitt and Weber	Face to face mission-critical ability	Persistent executive instruction set
Hayes and Sons	Enhanced explicit neural-net	Seamless high-level encryption
Stiedemann-Wiza	Optimized actuating matrices	Horizontal mission-critical contingency
Cronin-Paucek	Upgradable 4th generation pricing structure	Object-based uniform synergy
Spencer and Sons	Sharable exuding groupware	Team-oriented incremental Graphical User Interface
Nienow-Stehr	Progressive modular encoding	Innovative real-time middleware
Keeling Group	Inverse systemic service-desk	Vision-oriented attitude-oriented emulation
Wolff LLC	Managed responsive conglomeration	Face to face explicit Graphic Interface
Breitenberg, Jerde and Barrows	Exclusive reciprocal moratorium	Multi-tiered 24/7 array
Swift, Wyman and Predovic	Optional optimal architecture	Expanded zero administration complexity
Schultz and Sons	Universal discrete interface	Sharable actuating ability
Deckow Inc	Customizable mobile installation	Managed discrete concept
Kozey-Becker	Innovative 6th generation function	Cross-platform bottom-line knowledge user
Roob, Fahey and Eichmann	Inverse cohesive paradigm	Monitored regional orchestration
Kshlerin, Braun and Luettgen	Devolved secondary groupware	Mandatory object-oriented open architecture
Weber-Toy	Innovative asynchronous forecast	Intuitive solution-oriented migration
Stroman, Tremblay and Abshire	Synchronised impactful time-frame	Reactive 3rd generation support
Lebsack-Simonis	Persistent system-worthy concept	Public-key background budgetary management
Ernser-Kutch	Reverse-engineered reciprocal alliance	Synergized impactful task-force
Friesen, Mante and Jones	Advanced 4th generation support	Up-sized optimal portal
Terry Group	Team-oriented client-driven support	Visionary even-keeled process improvement
Fahey, Schinner and White	Optimized bi-directional matrix	Universal bi-directional capability
Parker, Runolfsson and DuBuque	Operative motivating groupware	Operative multi-state leverage
DuBuque Group	Profound even-keeled software	Expanded directional ability
Pollich Inc	Self-enabling impactful approach	Advanced bifurcated encryption
Deckow-Ferry	Advanced directional workforce	Proactive full-range project
Cruickshank, Schimmel and Gleichner	Versatile object-oriented process improvement	Extended 3rd generation open architecture
Kunde-Koss	Automated 5th generation firmware	Object-based logistical throughput
Balistreri Inc	Multi-tiered 5th generation knowledge base	Re-engineered assymetric time-frame
Muller-Zulauf	Reactive client-server knowledge user	Multi-channelled intangible archive
Abernathy LLC	Networked system-worthy contingency	Expanded multi-state policy
Schuster-Berge	Vision-oriented grid-enabled productivity	Profound 24/7 contingency
Wilkinson, Beer and Glover	Devolved explicit instruction set	Secured grid-enabled extranet
Dare-Bernier	Customer-focused exuding local area network	Adaptive national infrastructure
Kiehn-Armstrong	Visionary multimedia adapter	Intuitive executive firmware
Botsford, Zulauf and Pagac	Horizontal radical workforce	Self-enabling 3rd generation capacity
Kerluke-Hauck	Mandatory analyzing ability	Digitized bottom-line budgetary management
Mayer, Larson and Stroman	Synergized 24 hour synergy	Diverse stable knowledge base
Osinski-Quigley	Monitored 6th generation parallelism	Quality-focused homogeneous frame
Block-Anderson	Inverse incremental throughput	Total background task-force
O'Keefe-Leffler	Triple-buffered assymetric implementation	Customizable homogeneous leverage
Nader, Brown and Hoppe	Programmable hybrid circuit	Implemented heuristic toolset
Casper-Green	Streamlined holistic extranet	Centralized system-worthy core
Stanton-Stracke	Realigned bifurcated capability	Customizable disintermediate customer loyalty
Wolff, Okuneva and Gulgowski	Synchronised foreground internet solution	Switchable real-time moderator
Larson Inc	Cross-platform secondary synergy	Fully-configurable background database
Donnelly-Hand	Decentralized holistic application	Reactive zero tolerance structure
Hessel, Dickens and Abbott	Balanced static installation	Vision-oriented exuding middleware
Wiegand, Runte and VonRueden	Monitored system-worthy complexity	Profound empowering algorithm
Borer-Nitzsche	Future-proofed national website	Polarised contextually-based matrices
Thiel Group	Polarised motivating moderator	Inverse 4th generation frame
Monahan Group	Horizontal regional knowledge user	Focused bi-directional flexibility
Johnston Group	Synergized composite groupware	Polarised executive knowledge user
Hickle-Koepp	Seamless transitional hardware	Multi-layered content-based system engine
Glover-Ritchie	Managed human-resource info-mediaries	Upgradable actuating ability
Prohaska-Zieme	Public-key multi-state complexity	Object-based impactful focus group
Spencer, Bergnaum and Lesch	Business-focused disintermediate instruction set	Centralized national portal
Bechtelar-Emard	Advanced mission-critical frame	Stand-alone intangible pricing structure
Kovacek, Quigley and Zboncak	Distributed incremental knowledge user	Intuitive executive orchestration
Cole, Heidenreich and Morissette	Grass-roots maximized emulation	Future-proofed neutral knowledge user
Brekke-Mohr	Quality-focused foreground matrices	Proactive disintermediate project
Macejkovic, Ledner and Kunde	Right-sized tertiary model	Multi-lateral next generation framework
Stanton, Stracke and Crona	Reverse-engineered bi-directional matrix	Managed web-enabled task-force
Simonis Inc	Managed empowering circuit	Intuitive dynamic focus group
Morar-Hayes	Cross-group holistic core	Automated content-based archive
Huels Group	Implemented dynamic middleware	Configurable maximized internet solution
Kuphal-Miller	Compatible interactive alliance	Vision-oriented 6th generation hardware
Lesch Inc	Profit-focused secondary open system	Persevering human-resource application
Koelpin Inc	Reactive dedicated access	Organized 3rd generation throughput
Willms Inc	Re-engineered holistic product	Switchable intermediate project
Kling-Luettgen	Open-source leading edge access	Customizable dynamic implementation
Turcotte Inc	Public-key discrete circuit	Grass-roots zero tolerance emulation
Bernhard, Auer and Kertzmann	Down-sized intermediate hub	Cross-platform zero tolerance algorithm
Ortiz and Sons	Visionary high-level flexibility	Streamlined 24/7 adapter
Kulas, Yost and Wuckert	Expanded well-modulated capability	Enhanced heuristic toolset
Will, DuBuque and Blanda	Team-oriented assymetric approach	Future-proofed high-level info-mediaries
Prosacco, Yundt and Fritsch	Optimized tangible conglomeration	Assimilated executive productivity
Kihn, Ernser and Reynolds	Innovative zero defect toolset	Persistent tertiary forecast
Sipes-Nolan	Sharable secondary hardware	Optional next generation secured line
Rowe-Gulgowski	User-centric needs-based function	Implemented directional circuit
Sipes and Sons	Right-sized static conglomeration	Compatible secondary open system
Padberg-Lehner	Multi-tiered optimizing utilisation	Stand-alone even-keeled database
Crist Inc	Team-oriented leading edge workforce	Organic homogeneous definition
Denesik, Runolfsson and King	Reactive encompassing neural-net	Ameliorated homogeneous standardization
Metz, O'Keefe and Lebsack	Customizable empowering function	User-friendly leading edge access
Heaney and Sons	Ameliorated intangible Graphic Interface	Ameliorated cohesive customer loyalty
Konopelski, Trantow and Von	Fundamental mission-critical structure	Customer-focused global hub
Baumbach-Cassin	Visionary content-based focus group	Upgradable multi-tasking initiative
Johnston Group	Synergistic national extranet	Managed heuristic matrix
Aufderhar, Kutch and Dibbert	Grass-roots assymetric contingency	Expanded impactful encryption
Howe Inc	Open-source leading edge adapter	Object-based systematic parallelism
Kemmer, Gottlieb and Luettgen	Universal executive flexibility	Optional background adapter
Beahan, Rutherford and Stoltenberg	Monitored cohesive circuit	Assimilated bandwidth-monitored model
Lang-Johnston	Robust global circuit	Centralized homogeneous monitoring
Kunze-Walter	User-friendly maximized infrastructure	Multi-channelled system-worthy hardware
Langworth, Gottlieb and Dibbert	Secured bi-directional secured line	Multi-lateral bandwidth-monitored contingency
Bahringer, Abernathy and Braun	Multi-channelled next generation budgetary management	Persistent methodical projection
Berge-Harber	Centralized non-volatile Graphical User Interface	Programmable needs-based structure
Denesik Group	Re-contextualized user-facing migration	User-friendly national hub
Torp, Powlowski and Hermiston	Team-oriented dynamic instruction set	Automated content-based application
Dickens LLC	Switchable zero administration data-warehouse	Balanced empowering projection
Kovacek Inc	Ergonomic foreground secured line	Right-sized composite database
Mayer, Hodkiewicz and Lubowitz	Fundamental background task-force	Down-sized mobile installation
Yundt-Reilly	Customizable impactful complexity	Managed bi-directional alliance
Kihn, Raynor and Hirthe	Reactive global matrix	Implemented regional project
Beatty Group	Intuitive composite project	Customer-focused transitional middleware
Buckridge, Bartell and Hilll	Configurable holistic orchestration	Future-proofed upward-trending ability
Casper, Goldner and Schamberger	Persistent contextually-based budgetary management	Advanced composite standardization
Smith-Zieme	Down-sized 24/7 project	Cloned fresh-thinking help-desk
Mitchell, Braun and Ortiz	Configurable context-sensitive local area network	Organized high-level standardization
Mraz Group	Multi-tiered full-range portal	Phased didactic archive
Witting-Dach	Ameliorated explicit portal	Intuitive bottom-line archive
Boyle-Krajcik	Mandatory contextually-based instruction set	Digitized context-sensitive budgetary management
Cole-Hoeger	Right-sized clear-thinking knowledge base	Face to face reciprocal monitoring
Christiansen-Bashirian	Realigned dynamic matrices	Customizable 5th generation Graphical User Interface
Nienow-Larkin	Horizontal well-modulated Graphic Interface	Cross-group value-added knowledge user
Johnston-Harber	Fully-configurable leading edge function	Business-focused modular process improvement
O'Connell-McKenzie	Proactive explicit intranet	De-engineered intermediate solution
Nienow, Konopelski and Dibbert	Phased heuristic capability	Total heuristic process improvement
Howe, Fay and Fahey	Enhanced bifurcated data-warehouse	Intuitive coherent local area network
Hills-Nader	Open-source contextually-based service-desk	Monitored multi-state groupware
Lebsack-Beatty	Advanced holistic concept	User-centric fault-tolerant hardware
Wunsch-Runolfsson	Digitized bifurcated collaboration	Realigned actuating solution
Walsh, Abbott and McDermott	Managed tertiary hub	Advanced secondary approach
Grimes, Hermiston and Torp	Business-focused disintermediate archive	Robust demand-driven capacity
Thiel, Renner and Prohaska	Switchable responsive infrastructure	Digitized multimedia challenge
Kuhic, Prohaska and O'Keefe	Synergistic full-range synergy	Virtual full-range benchmark
Crooks Group	Stand-alone analyzing moratorium	Profit-focused empowering hierarchy
Legros Group	Up-sized demand-driven conglomeration	Networked tertiary moderator
Wintheiser Inc	Exclusive fault-tolerant database	Open-architected homogeneous capability
Schamberger, Kuhlman and Wilkinson	Robust transitional challenge	Integrated system-worthy emulation
Quigley, Deckow and Larkin	Future-proofed clear-thinking migration	Advanced systematic open system
Wuckert and Sons	Networked analyzing secured line	Centralized transitional workforce
Treutel, O'Hara and Hauck	Persevering coherent artificial intelligence	Ergonomic bottom-line help-desk
Conroy, Grady and Hammes	Right-sized well-modulated emulation	Inverse scalable Graphic Interface
Keeling-Marks	Up-sized static monitoring	Diverse coherent productivity
Schoen, Bruen and Nolan	Cross-platform background projection	Re-engineered local instruction set
Goodwin Group	Phased content-based monitoring	Grass-roots demand-driven intranet
Conroy and Sons	Extended disintermediate matrices	Innovative zero defect array
Schmidt-Monahan	Virtual didactic frame	Integrated systematic info-mediaries
Block-Toy	Persistent incremental application	Object-based bandwidth-monitored firmware
Towne, Daugherty and Schimmel	Switchable tertiary policy	Assimilated dynamic migration
Green-Hagenes	Ergonomic fault-tolerant matrix	Grass-roots systematic monitoring
Lueilwitz LLC	Self-enabling tertiary product	Organized zero tolerance portal
Gusikowski-Kiehn	Decentralized maximized system engine	User-friendly solution-oriented implementation
Hickle LLC	Inverse motivating architecture	Cloned foreground moratorium
Gusikowski-Cummerata	Assimilated client-server data-warehouse	Expanded encompassing budgetary management
Renner and Sons	Business-focused upward-trending throughput	Automated next generation attitude
Nikolaus, Ullrich and Dicki	Devolved local process improvement	Reduced 24 hour alliance
Wyman, Feeney and Bergnaum	Distributed modular functionalities	Synergized foreground interface
Keeling Group	Balanced empowering task-force	Polarised responsive knowledge base
Runolfsson Group	Assimilated methodical alliance	Horizontal system-worthy support
Wilderman-Hoppe	Streamlined leading edge matrix	Customer-focused non-volatile application
O'Hara and Sons	Exclusive 3rd generation instruction set	Networked neutral open architecture
Steuber Group	Grass-roots explicit array	User-centric global info-mediaries
Batz, Schneider and Mayert	Public-key context-sensitive conglomeration	Future-proofed stable synergy
Barrows-Rice	Seamless real-time toolset	Realigned heuristic solution
Baumbach, Wisozk and Jaskolski	Inverse encompassing success	Visionary context-sensitive internet solution
Toy-Collier	Intuitive local task-force	Synergistic zero defect interface
Stark and Sons	Enhanced disintermediate website	Synergistic radical open system
Heidenreich, Bernier and Cummings	Multi-layered fault-tolerant function	Multi-layered multi-tasking collaboration
Pfannerstill, Stokes and Heidenreich	Innovative disintermediate utilisation	Inverse tertiary throughput
Mitchell, Nienow and Corkery	Reactive context-sensitive structure	Streamlined empowering system engine
Hickle Group	Organic global hardware	Programmable homogeneous info-mediaries
Trantow LLC	Adaptive bottom-line support	Universal directional ability
Ziemann Inc	Open-source well-modulated info-mediaries	Extended fresh-thinking open architecture
Corkery-Mante	Multi-tiered local groupware	Proactive grid-enabled frame
Gutkowski Group	Phased scalable moratorium	Implemented leading edge info-mediaries
Bayer LLC	Profit-focused bandwidth-monitored hub	Public-key responsive moratorium
Collins Group	Adaptive client-driven extranet	De-engineered radical moderator
Carroll, Aufderhar and Gleason	Intuitive 5th generation frame	Optional object-oriented open architecture
Becker-Kovacek	Switchable demand-driven installation	Reactive well-modulated groupware
Marvin, Prohaska and Marquardt	Integrated cohesive capability	Phased mission-critical Graphic Interface
Corkery, Beahan and Zieme	Digitized asynchronous encoding	Automated intangible firmware
Erdman, Howell and Bechtelar	Re-contextualized mobile analyzer	Persevering static Graphical User Interface
Padberg, Cruickshank and Upton	Centralized transitional website	Secured upward-trending database
Wilkinson-Jakubowski	Programmable dedicated support	Configurable clear-thinking application
Bins and Sons	Front-line multi-tasking concept	Polarised modular workforce
Franecki Inc	Monitored executive pricing structure	Cross-platform intermediate encoding
Lang, Romaguera and Gusikowski	Progressive dedicated solution	Reactive holistic methodology
Barton, Quitzon and Mayer	Public-key systematic firmware	Organic grid-enabled local area network
Ruecker, Kirlin and Renner	Synergistic logistical complexity	Exclusive even-keeled service-desk
Jacobi, Walsh and Schuppe	Networked even-keeled productivity	Robust bandwidth-monitored hardware
Buckridge Inc	Profound homogeneous ability	Compatible assymetric workforce
Harris, Ondricka and Littel	Distributed maximized monitoring	Centralized mobile knowledge user
Torphy-Hickle	Adaptive value-added approach	Inverse coherent encryption
Gottlieb-Miller	Ergonomic modular functionalities	De-engineered value-added array
Kirlin-Schamberger	Customizable coherent forecast	Synergized 4th generation data-warehouse
Dicki-Bednar	Total discrete help-desk	Public-key zero defect orchestration
Lockman, Hirthe and Steuber	Digitized non-volatile instruction set	Profit-focused even-keeled adapter
Wilderman and Sons	Progressive incremental monitoring	Proactive bottom-line frame
Koch-Walker	Object-based scalable complexity	Adaptive fresh-thinking success
Walsh-Cummings	Switchable value-added infrastructure	Realigned disintermediate capacity
O'Keefe-Osinski	Robust scalable contingency	Persistent demand-driven matrices
Jaskolski and Sons	Up-sized motivating neural-net	Streamlined demand-driven benchmark
Pfannerstill-Lockman	Seamless incremental moderator	Devolved secondary project
Fay, Grant and Shields	Optimized systemic interface	User-friendly encompassing instruction set
Huels-Zulauf	Automated value-added capacity	Versatile motivating analyzer
Hammes-Walter	Horizontal global moderator	Adaptive local standardization
Hauck LLC	Networked multi-tasking focus group	Versatile methodical Graphical User Interface
Heathcote Group	Customer-focused bottom-line intranet	Configurable next generation middleware
Padberg LLC	Programmable transitional policy	Assimilated dedicated focus group
Auer-Champlin	Total assymetric protocol	Reactive 24 hour paradigm
Witting-Stokes	Advanced needs-based adapter	Synergized 24 hour help-desk
Howell, Aufderhar and Schmeler	Devolved executive website	Organic 4th generation Graphical User Interface
Gerhold-Wilkinson	Secured bifurcated knowledge base	Fundamental foreground attitude
Satterfield-Hackett	Extended demand-driven firmware	Polarised demand-driven secured line
Fisher Group	Distributed methodical product	Expanded zero defect project
Rosenbaum LLC	Cross-group methodical moderator	Diverse clear-thinking artificial intelligence
Flatley Inc	Realigned encompassing info-mediaries	Fundamental full-range installation
Koss-Waelchi	Sharable human-resource ability	Synergized modular focus group
Gutkowski Group	Stand-alone secondary secured line	Balanced full-range encryption
Crona, Mayert and Breitenberg	Persevering national process improvement	Mandatory zero tolerance info-mediaries
Kihn-Kohler	Synergistic tertiary concept	Public-key coherent superstructure
Rosenbaum-Jerde	Universal eco-centric info-mediaries	Re-engineered dedicated neural-net
King LLC	Extended dynamic hub	Front-line 6th generation conglomeration
Kunze and Sons	Ergonomic bandwidth-monitored extranet	Streamlined stable support
Kling-Kunze	Compatible interactive budgetary management	Innovative leading edge utilisation
Keebler-Jenkins	Optimized executive leverage	Innovative non-volatile analyzer
Borer Group	Right-sized stable moderator	Cross-platform needs-based forecast
Eichmann, Jakubowski and Goodwin	Organized incremental system engine	Down-sized uniform monitoring
Denesik, Rutherford and Beier	Profound 24 hour task-force	Universal secondary collaboration
Dickinson, Weimann and Ritchie	Distributed value-added archive	Diverse human-resource flexibility
Jast-Kuhic	Decentralized clear-thinking productivity	Persistent zero tolerance database
Kreiger and Sons	Profit-focused well-modulated forecast	Digitized logistical success
Heidenreich, Boehm and Padberg	Future-proofed leading edge benchmark	Visionary analyzing ability
Schamberger-Lueilwitz	Customer-focused asynchronous interface	Robust web-enabled policy
Keeling, Kertzmann and Mayert	Reverse-engineered web-enabled definition	Managed explicit installation
Wolf, Leuschke and Harvey	Polarised high-level challenge	Monitored client-server artificial intelligence
Homenick and Sons	Profound assymetric database	Monitored composite application
Wiegand, Ziemann and Rempel	Customizable zero administration product	Cross-group global archive
Brekke, Abbott and Durgan	Synergized scalable internet solution	Virtual 6th generation alliance
Witting, Doyle and Cronin	Proactive stable solution	Reduced heuristic open system
Sauer, Schamberger and West	Extended zero administration projection	Synchronised fresh-thinking artificial intelligence
Effertz, Pouros and Beier	Advanced zero tolerance leverage	Mandatory composite algorithm
Marquardt-Hudson	User-centric heuristic moratorium	Function-based secondary firmware
Kreiger-Kuhic	Devolved demand-driven task-force	Customer-focused fresh-thinking infrastructure
Wiegand Group	Right-sized system-worthy website	Robust full-range intranet
Tillman, Schuster and Rodriguez	Intuitive heuristic implementation	Cross-group secondary capacity
West Group	Multi-channelled heuristic throughput	Universal 24 hour adapter
Barrows, Ankunding and Thompson	Ergonomic encompassing database	Digitized regional functionalities
King-Hagenes	Universal client-driven neural-net	Organic 4th generation customer loyalty
Tromp-Funk	Total reciprocal product	Cross-platform contextually-based core
Ferry, Hauck and Pfannerstill	Profound asynchronous system engine	Universal 6th generation analyzer
Conn, Schaden and Bednar	Persevering hybrid implementation	Ergonomic bifurcated capacity
Bins-Heller	Ergonomic mobile support	Intuitive maximized synergy
Grady Group	Customer-focused disintermediate migration	Intuitive zero administration local area network
Nicolas, Brakus and Schowalter	Public-key national leverage	Open-architected incremental success
Sporer Group	Front-line encompassing firmware	Optimized 4th generation product
Sanford LLC	Business-focused actuating monitoring	Secured well-modulated encryption
Schaden Inc	Secured stable collaboration	De-engineered multi-tasking adapter
Treutel-Pacocha	Centralized client-server standardization	Expanded assymetric support
Baumbach, Douglas and Towne	Assimilated directional throughput	Synergistic intermediate moratorium
Dach, Lynch and Bayer	Sharable 4th generation array	Customizable analyzing implementation
Herman-Davis	Upgradable demand-driven function	Automated fresh-thinking groupware
Senger-Brown	De-engineered methodical installation	Right-sized context-sensitive open system
Cassin and Sons	Devolved multimedia strategy	Monitored methodical infrastructure
Roob and Sons	Robust client-driven productivity	Synchronised intangible emulation
Hartmann and Sons	Managed solution-oriented solution	Secured mobile core
Hackett-O'Keefe	Down-sized interactive structure	Seamless didactic functionalities
Greenholt, Heaney and Stamm	Mandatory encompassing orchestration	Extended secondary focus group
Hane and Sons	Face to face maximized artificial intelligence	Up-sized 6th generation challenge
Mayert Inc	Public-key encompassing capacity	Cross-group grid-enabled definition
O'Reilly-Flatley	Fully-configurable exuding portal	Distributed impactful neural-net
Wuckert LLC	Profit-focused zero administration focus group	Cross-platform static core
Eichmann, Osinski and Kuphal	Automated neutral portal	Synchronised empowering database
Ankunding, Prosacco and Price	Synergized cohesive emulation	Implemented didactic parallelism
Ledner LLC	Virtual tangible portal	Streamlined 5th generation emulation
Erdman LLC	Progressive content-based info-mediaries	Diverse hybrid software
Kozey Inc	Triple-buffered human-resource paradigm	Reduced mission-critical time-frame
Heathcote, Green and Romaguera	Enhanced upward-trending core	Self-enabling local data-warehouse
Ward-Boehm	Integrated analyzing function	Balanced holistic knowledge base
Legros, Bogisich and Nicolas	Synchronised needs-based extranet	Re-contextualized responsive portal
Boyle-Veum	Seamless discrete matrix	Multi-tiered tertiary focus group
Bauch, Rutherford and Schroeder	Customizable zero administration knowledge user	Face to face intangible parallelism
Bins, Jast and Jerde	Open-source contextually-based capacity	Programmable assymetric alliance
Feest and Sons	Reduced context-sensitive methodology	Cloned non-volatile alliance
Cremin-Harvey	Synergized attitude-oriented moratorium	Synergized leading edge projection
Nicolas-Moore	Team-oriented stable synergy	Robust national matrices
Upton, Bernier and Crona	User-centric secondary approach	Organized value-added utilisation
Stehr, Osinski and Fritsch	Pre-emptive regional functionalities	Upgradable reciprocal productivity
Bahringer-Grady	Reactive logistical archive	Stand-alone maximized task-force
Hyatt and Sons	De-engineered 6th generation array	Re-engineered 6th generation internet solution
Pfannerstill-Parisian	Right-sized bandwidth-monitored groupware	Total foreground adapter
Casper Group	Automated disintermediate conglomeration	Innovative homogeneous parallelism
Ullrich-Huels	Devolved encompassing core	Future-proofed foreground utilisation
Dare-Fay	Fundamental incremental project	Robust systematic support
Lynch, Reichel and Mueller	Multi-tiered intermediate adapter	Cloned bandwidth-monitored policy
Torphy-Rowe	Diverse upward-trending benchmark	Pre-emptive leading edge structure
Walter and Sons	Universal content-based help-desk	Implemented logistical process improvement
Johnston-Hansen	Face to face even-keeled groupware	Face to face web-enabled paradigm
Murray, Lind and Wiza	Networked intermediate task-force	Cloned transitional frame
McLaughlin, Renner and Lockman	Extended solution-oriented instruction set	Compatible clear-thinking concept
Reichert, Flatley and White	Object-based web-enabled open system	Organic fresh-thinking time-frame
Gutkowski Group	Mandatory radical approach	Decentralized heuristic database
Kunde-Gleason	Public-key holistic infrastructure	Monitored asynchronous structure
Dach, Waelchi and O'Keefe	Customer-focused asynchronous interface	Upgradable national standardization
Ferry, Flatley and Purdy	User-friendly dedicated instruction set	Streamlined zero defect installation
Rohan LLC	Proactive holistic architecture	Devolved 4th generation installation
Windler, Kunde and Adams	Grass-roots systematic neural-net	Intuitive intangible local area network
Pacocha-Ferry	Organic transitional moderator	Virtual executive archive
Jenkins Inc	Profit-focused leading edge archive	Re-engineered client-driven matrices
Batz, Powlowski and Jast	Polarised assymetric interface	Customer-focused coherent focus group
Gerlach, Koelpin and Berge	Triple-buffered heuristic complexity	Fundamental actuating software
Bednar, Koelpin and Hayes	Expanded multi-state challenge	Adaptive exuding strategy
Abshire Inc	Fully-configurable fresh-thinking pricing structure	Mandatory demand-driven service-desk
Gleichner, Renner and Bradtke	Enhanced non-volatile attitude	Cloned discrete paradigm
Ortiz-Schaefer	Persistent fault-tolerant solution	Realigned maximized capability
Monahan-Satterfield	Enterprise-wide intermediate encryption	Team-oriented grid-enabled website
Johnson-Orn	De-engineered multi-tasking installation	Proactive executive functionalities
Bartoletti-Wolff	Reduced explicit Graphical User Interface	Business-focused logistical monitoring
Parisian-Goldner	Business-focused radical artificial intelligence	Exclusive reciprocal methodology
Dickens-Kub	Distributed high-level synergy	Cloned actuating encryption
Harvey-Marvin	Configurable even-keeled Graphical User Interface	Virtual heuristic model
Goodwin and Sons	User-friendly 4th generation process improvement	Enhanced optimal time-frame
Raynor, Brown and Bahringer	Seamless bandwidth-monitored emulation	Expanded 24/7 time-frame
Stamm, Bogisich and Terry	Diverse stable synergy	Profound secondary interface
Baumbach-Parisian	Down-sized uniform benchmark	Enhanced hybrid circuit
Veum, Marks and Champlin	Assimilated multimedia leverage	Reactive grid-enabled success
O'Connell-Jacobs	Decentralized reciprocal concept	Enhanced dedicated leverage
Bruen-Muller	Horizontal dedicated methodology	Phased attitude-oriented knowledge user
Reilly, Orn and Hagenes	Self-enabling needs-based intranet	Optimized multi-state application
McLaughlin and Sons	Focused value-added hardware	Re-engineered global attitude
Windler Group	Down-sized mobile monitoring	Triple-buffered multimedia conglomeration
Casper LLC	Decentralized encompassing core	Realigned reciprocal productivity
Wisoky-Anderson	Front-line impactful leverage	Multi-layered dedicated groupware
Carroll-Rogahn	Optimized 6th generation customer loyalty	Business-focused asynchronous leverage
Fritsch LLC	Intuitive discrete knowledge user	Progressive optimizing orchestration
Zulauf, Roberts and Kuphal	Future-proofed leading edge algorithm	Persevering responsive ability
Metz-Block	Devolved multi-state hierarchy	Intuitive scalable protocol
Weimann, Macejkovic and Cole	Intuitive leading edge encoding	Ameliorated asynchronous open system
Tremblay, Gutkowski and Bartoletti	Enterprise-wide context-sensitive forecast	Seamless directional migration
Collier-Skiles	Self-enabling demand-driven process improvement	Phased next generation extranet
Okuneva-Flatley	Extended assymetric info-mediaries	Mandatory homogeneous benchmark
Wunsch-Pollich	Front-line local structure	Persistent human-resource portal
Padberg Group	Pre-emptive foreground paradigm	Universal real-time data-warehouse
Wiegand-Robel	Synergized 5th generation model	Reverse-engineered bottom-line knowledge user
Schmitt-Pfannerstill	Organized even-keeled neural-net	Enterprise-wide secondary website
Kshlerin Group	Intuitive human-resource synergy	Distributed empowering installation
Pacocha, Hettinger and White	Phased explicit attitude	Streamlined fresh-thinking knowledge user
Cole, Fisher and Harris	Reduced interactive help-desk	Synergistic global solution
Waters Group	Configurable transitional website	Profit-focused bandwidth-monitored process improvement
Littel-Ebert	Extended tertiary open system	Balanced systemic encryption
Zulauf Inc	Vision-oriented web-enabled project	Switchable homogeneous structure
Olson-Abshire	Vision-oriented static data-warehouse	Extended executive architecture
Koepp, White and Crist	Innovative interactive artificial intelligence	Front-line regional help-desk
VonRueden-Windler	Object-based upward-trending productivity	Public-key bandwidth-monitored capability
Roob, Roob and Rosenbaum	Quality-focused multimedia approach	Synchronised scalable middleware
Huel Inc	Down-sized exuding synergy	Synergized well-modulated toolset
Kertzmann, Hoppe and D'Amore	Organic static encoding	Organic human-resource website
Raynor, Boehm and Beatty	Vision-oriented human-resource core	Profound asynchronous challenge
Jenkins-Dooley	Extended client-server knowledge user	Realigned contextually-based Graphic Interface
Thompson, O'Reilly and Sipes	Integrated multi-state time-frame	Progressive bottom-line encryption
Hilpert-Leannon	Object-based secondary knowledge base	Object-based actuating software
Anderson Inc	Configurable regional capacity	Vision-oriented 3rd generation function
Stark-Osinski	Future-proofed assymetric matrices	Visionary national matrix
Franecki Inc	Secured hybrid interface	Organic holistic application
Gulgowski and Sons	Intuitive explicit extranet	Organized 6th generation challenge
Wilkinson, Gutkowski and Rice	Object-based human-resource extranet	Diverse logistical model
Lesch-Carter	Grass-roots executive algorithm	Face to face hybrid challenge
Altenwerth-Kuhlman	Profit-focused motivating emulation	Open-architected client-driven application
Halvorson, Nienow and Kertzmann	Persistent disintermediate workforce	Synchronised interactive leverage
Hilll Inc	Self-enabling executive approach	Inverse homogeneous help-desk
Wehner-Homenick	Visionary tangible knowledge user	Reverse-engineered bandwidth-monitored task-force
Pfeffer LLC	Ergonomic responsive definition	Persevering secondary methodology
O'Kon, Boyle and Gislason	Grass-roots system-worthy hierarchy	Up-sized responsive adapter
Baumbach LLC	Face to face 6th generation Graphic Interface	Operative empowering pricing structure
Pfannerstill, Braun and Goyette	Networked system-worthy methodology	Digitized discrete architecture
White LLC	User-friendly 5th generation open system	Mandatory even-keeled hierarchy
Wolff Inc	Secured contextually-based success	Fully-configurable assymetric website
Greenfelder, Abshire and Goldner	Total bottom-line capacity	Multi-layered needs-based task-force
Balistreri-Marquardt	Monitored assymetric product	Centralized bottom-line implementation
Okuneva LLC	Optional tangible hardware	Seamless executive solution
Hilll-Jones	Horizontal zero tolerance benchmark	Optimized maximized function
Haag Group	Decentralized content-based ability	Organic disintermediate implementation
DuBuque Inc	Organized didactic throughput	Total well-modulated Graphic Interface
Reichert Group	Inverse incremental framework	Team-oriented client-server capability
Leannon LLC	Cloned fault-tolerant knowledge user	Total real-time knowledge user
Graham-Kshlerin	Seamless needs-based data-warehouse	Automated 24 hour hardware
Skiles, Mitchell and Johns	Self-enabling motivating structure	Intuitive impactful focus group
Kohler, Watsica and Kiehn	Optional fault-tolerant system engine	Customer-focused empowering matrix
Fisher LLC	Customer-focused scalable superstructure	Public-key directional forecast
Collier and Sons	Digitized bandwidth-monitored open system	Persistent homogeneous adapter
Larkin, Hahn and Ullrich	Persistent dedicated capacity	Total incremental task-force
Mertz-Borer	Upgradable bifurcated adapter	Automated asynchronous installation
Cronin Group	User-centric stable time-frame	Polarised multi-state framework
Rippin Group	Balanced 5th generation access	User-friendly high-level monitoring
Collier, Ratke and Muller	Programmable bifurcated benchmark	Enterprise-wide optimal moratorium
Keebler LLC	Horizontal discrete projection	Ameliorated 3rd generation service-desk
Herman Inc	Versatile explicit product	Persevering secondary secured line
Rau Inc	Advanced non-volatile throughput	Synchronised mission-critical data-warehouse
Koss, Gerhold and Herman	Public-key modular synergy	Cloned tangible access
Howell and Sons	Synchronised clear-thinking orchestration	Centralized impactful matrices
Macejkovic, Hagenes and Maggio	Robust hybrid leverage	Multi-layered well-modulated time-frame
Champlin, Grimes and Kuhn	Quality-focused disintermediate strategy	Stand-alone hybrid pricing structure
Herman and Sons	Inverse systematic secured line	Inverse bifurcated structure
Reichert-Padberg	Diverse discrete firmware	Profound non-volatile utilisation
Hammes Group	Devolved well-modulated migration	Right-sized responsive firmware
Sauer Group	Advanced static superstructure	Progressive radical service-desk
Runolfsson, Turcotte and Gusikowski	Team-oriented maximized focus group	Multi-channelled directional local area network
Stroman-Bogisich	Phased heuristic support	Sharable secondary paradigm
Boyle-Haley	Business-focused dynamic encryption	User-friendly exuding protocol
Paucek Inc	Multi-layered analyzing protocol	Seamless exuding internet solution
Bergstrom, Hettinger and Adams	Right-sized impactful adapter	Managed directional strategy
Ernser, Wisozk and Hettinger	Visionary dedicated firmware	Virtual human-resource solution
Feeney, Breitenberg and Kautzer	Robust needs-based emulation	Persevering zero administration model
Crist, Renner and Kerluke	Multi-tiered eco-centric solution	User-centric well-modulated local area network
Weissnat, Ritchie and Zemlak	Organized static project	User-centric bandwidth-monitored focus group
Lowe and Sons	Visionary uniform framework	Synergistic dedicated open architecture
Conroy, Greenholt and Wintheiser	Innovative systemic capacity	Innovative systemic parallelism
McClure Group	Future-proofed attitude-oriented groupware	Polarised optimizing definition
Rau Inc	Face to face 6th generation paradigm	User-friendly next generation circuit
Stanton-Haley	Optional bandwidth-monitored open architecture	Switchable transitional methodology
Labadie-Ankunding	Open-source context-sensitive matrices	Centralized 24/7 access
Lindgren and Sons	Advanced static open system	Enterprise-wide dedicated ability
Rath LLC	Synchronised mobile challenge	Re-engineered 6th generation task-force
Oberbrunner Inc	Exclusive bifurcated collaboration	Sharable 24 hour forecast
Okuneva-Maggio	Optional background orchestration	Horizontal value-added model
Deckow and Sons	Adaptive needs-based framework	Reactive real-time architecture
Goodwin Group	Expanded 5th generation paradigm	Re-engineered zero administration ability
Runolfsdottir, Lowe and Haley	Multi-lateral local strategy	Quality-focused asynchronous migration
Hettinger-Abbott	Extended zero defect definition	Optimized 5th generation structure
Nikolaus, Stehr and Schuster	Expanded regional standardization	Programmable logistical pricing structure
Zemlak-Rodriguez	Open-source directional matrices	Object-based multimedia Graphical User Interface
Koelpin-Schinner	Universal static local area network	Extended maximized encoding
Connelly, Bergnaum and Murazik	Balanced explicit success	Open-architected optimal system engine
Gerhold Inc	Horizontal bifurcated alliance	Multi-channelled executive intranet
Will, Murazik and Keebler	De-engineered dynamic moderator	Down-sized clear-thinking matrices
Paucek-Torp	Decentralized 3rd generation implementation	Upgradable intermediate success
O'Connell-Brakus	Balanced client-server access	Synergized demand-driven forecast
Dibbert-Gerhold	Robust zero administration encryption	Diverse solution-oriented standardization
Zulauf-Lubowitz	Visionary disintermediate paradigm	Reactive bi-directional hardware
O'Hara Group	Grass-roots methodical parallelism	Adaptive bi-directional analyzer
Wiza Inc	Front-line cohesive utilisation	Realigned zero administration capacity
Jaskolski-Von	Reactive next generation function	Upgradable explicit local area network
Terry Group	Streamlined regional Graphic Interface	Inverse tangible initiative
Welch, Marks and Durgan	Open-source foreground array	Proactive intangible toolset
Swift, Hand and Stehr	Re-engineered cohesive extranet	Diverse didactic installation
Reichert-Schultz	Switchable systematic groupware	Reactive empowering challenge
Labadie and Sons	User-centric secondary definition	Decentralized responsive alliance
Lakin Inc	Ergonomic zero defect instruction set	Operative coherent strategy
Wolf Inc	Reactive methodical software	Advanced client-driven groupware
Orn, Beier and Ziemann	Object-based bifurcated budgetary management	Organic optimal ability
Watsica and Sons	Down-sized zero tolerance concept	Monitored needs-based extranet
Nader, Jenkins and Swift	Customizable secondary moderator	Ergonomic intermediate model
Ward, Muller and Rau	Robust next generation superstructure	Customer-focused secondary matrix
Reichel-Goldner	Extended cohesive synergy	Synergistic 6th generation projection
Braun LLC	Diverse national customer loyalty	Business-focused directional protocol
Bradtke, Prohaska and Beahan	Intuitive scalable task-force	Optimized bi-directional groupware
Rogahn Group	Object-based exuding solution	Adaptive incremental capability
Schulist-Bruen	Front-line upward-trending hardware	Focused bottom-line attitude
D'Amore, Herzog and Walker	Distributed responsive service-desk	Virtual reciprocal forecast
Abshire-Stiedemann	Configurable upward-trending hierarchy	Adaptive 6th generation algorithm
Leannon Inc	Synergistic national artificial intelligence	Fundamental web-enabled process improvement
Krajcik, Stamm and Monahan	Ergonomic high-level parallelism	Optional even-keeled capacity
Lebsack-Rippin	Secured systematic support	Multi-lateral composite complexity
Rath Inc	Decentralized intangible portal	Reverse-engineered contextually-based archive
Gislason-Johnston	Focused fault-tolerant implementation	Reactive actuating frame
Gutmann-Walker	Versatile web-enabled portal	Visionary didactic software
Murray, Emard and Doyle	Front-line leading edge utilisation	Visionary next generation attitude
Keebler Inc	Re-contextualized uniform protocol	Devolved zero administration architecture
Nitzsche, Hettinger and Pfannerstill	Programmable bottom-line solution	Reactive value-added protocol
Oberbrunner, Fisher and Sauer	Vision-oriented responsive hardware	Progressive composite functionalities
Mann-Kohler	Reduced bi-directional alliance	Persistent real-time intranet
Koss-Adams	Customer-focused interactive leverage	Phased interactive website
Runte-Hessel	Devolved solution-oriented moratorium	Compatible regional approach
McKenzie-Kuhic	Configurable assymetric extranet	Mandatory 3rd generation knowledge base
Williamson-Ebert	Integrated uniform task-force	Profit-focused assymetric success
Jenkins-Stanton	Fully-configurable intermediate infrastructure	Business-focused stable hardware
Hilll-Kshlerin	Digitized 3rd generation protocol	Robust regional service-desk
Jast and Sons	Right-sized exuding initiative	Down-sized mobile hierarchy
Kessler-Mitchell	Monitored non-volatile policy	Multi-lateral exuding instruction set
Armstrong, Wuckert and Robel	Vision-oriented responsive algorithm	Diverse asynchronous open system
Lind Inc	Exclusive exuding emulation	Innovative value-added project
Jacobson, Shields and Pfeffer	Optimized full-range website	Diverse tangible system engine
Gutkowski LLC	Virtual cohesive data-warehouse	Right-sized neutral encoding
Gerhold, Frami and Halvorson	Distributed exuding Graphical User Interface	Phased local policy
Weber-Brekke	Programmable radical core	Optional fault-tolerant middleware
Herzog and Sons	Right-sized actuating capability	Persevering value-added customer loyalty
Zemlak, Langworth and Upton	Ameliorated content-based knowledge user	Open-architected static website
Cummerata and Sons	Universal cohesive projection	Front-line methodical throughput
Denesik-Steuber	Extended web-enabled instruction set	Synergized secondary attitude
Swaniawski and Sons	Cross-platform 3rd generation success	Inverse systematic firmware
Welch-Miller	Diverse multi-state hardware	Streamlined user-facing customer loyalty
Wunsch, Lowe and Wunsch	Vision-oriented directional encryption	Organic dynamic product
McCullough, Gerhold and Denesik	Seamless executive initiative	Networked cohesive definition
Kunze-Erdman	Polarised disintermediate infrastructure	Object-based zero tolerance circuit
Brown-Krajcik	Re-contextualized well-modulated hierarchy	Multi-layered bandwidth-monitored data-warehouse
Ritchie, Erdman and Konopelski	Exclusive 4th generation system engine	Profit-focused grid-enabled complexity
Rohan, Predovic and Feeney	Upgradable 3rd generation solution	Up-sized responsive core
Pfannerstill, Fay and Dietrich	Monitored composite time-frame	Fundamental well-modulated encoding
Rodriguez Group	Organic full-range core	Persevering web-enabled product
Hermann-Ratke	Progressive zero defect capability	Expanded content-based budgetary management
Wolff Inc	Persevering contextually-based analyzer	Profound regional interface
Nitzsche, Murray and Grimes	Fully-configurable responsive hub	Robust heuristic time-frame
Weber Inc	Optional executive service-desk	Innovative encompassing matrices
McDermott Inc	User-friendly mobile matrices	Reverse-engineered bi-directional internet solution
Olson-Graham	Customer-focused secondary capability	Virtual mission-critical attitude
Kub and Sons	Function-based incremental protocol	De-engineered assymetric capability
White Group	Object-based asynchronous open system	Seamless object-oriented attitude
Pfeffer and Sons	Pre-emptive explicit leverage	Diverse logistical access
Medhurst LLC	Cloned encompassing contingency	Ergonomic intangible array
Daugherty-Shields	Versatile system-worthy workforce	Persevering systemic utilisation
Heathcote-Nienow	Monitored zero tolerance installation	Upgradable bottom-line strategy
Marvin LLC	Assimilated heuristic collaboration	Multi-channelled interactive data-warehouse
Wuckert, Becker and Graham	Upgradable fault-tolerant toolset	Universal regional projection
Rau Inc	Compatible coherent core	Right-sized motivating data-warehouse
Batz-Hyatt	Future-proofed user-facing structure	Diverse 6th generation policy
Hyatt-Bednar	Fundamental context-sensitive superstructure	Implemented real-time architecture
Hilll-Wolff	Integrated human-resource definition	Vision-oriented multimedia frame
Pouros, Klein and Braun	Total zero defect database	Multi-layered discrete matrices
Friesen, Gorczany and Feest	Profound multi-state software	Streamlined content-based functionalities
Schoen, Leuschke and Sawayn	Universal executive frame	Robust regional workforce
Larkin LLC	Enterprise-wide didactic orchestration	Cross-platform neutral intranet
Wuckert-Zulauf	Quality-focused clear-thinking capacity	Reduced modular initiative
Kassulke LLC	Quality-focused 3rd generation budgetary management	Centralized incremental projection
Mraz Inc	Secured tertiary infrastructure	Visionary multi-state Graphic Interface
Dare Group	Synchronised system-worthy system engine	Synergistic maximized portal
Mayer, Kohler and Dooley	Reduced 4th generation matrix	Enterprise-wide bottom-line capability
Braun Inc	Cross-group system-worthy benchmark	Diverse dedicated projection
Windler LLC	User-friendly mission-critical emulation	Universal explicit instruction set
Barrows, Wolff and Stamm	Reverse-engineered incremental pricing structure	Intuitive didactic flexibility
Yost LLC	Assimilated attitude-oriented instruction set	Public-key explicit product
Kassulke Group	Self-enabling fault-tolerant secured line	Assimilated logistical forecast
Muller, Bogan and Baumbach	Universal secondary info-mediaries	Profit-focused well-modulated secured line
Mann-Nader	Reverse-engineered regional project	Horizontal 4th generation firmware
Welch-O'Reilly	Visionary tangible data-warehouse	Down-sized background encoding
Mosciski, Johns and Dare	Persevering modular workforce	Total disintermediate groupware
Zboncak, Langosh and Lubowitz	Open-architected foreground help-desk	Synchronised background methodology
Stracke, Turner and Jacobi	Inverse background ability	Compatible interactive success
Collins and Sons	Self-enabling 4th generation orchestration	Organic stable website
Hodkiewicz Inc	Decentralized value-added parallelism	Digitized contextually-based core
Dietrich, Hermann and Watsica	Compatible cohesive capacity	Devolved bottom-line strategy
Casper-Cormier	Ameliorated non-volatile instruction set	User-friendly multi-tasking definition
Schowalter and Sons	Phased eco-centric leverage	Horizontal multi-tasking time-frame
Pfannerstill, Rutherford and Stark	Monitored leading edge policy	Proactive intangible moratorium
Monahan-Simonis	De-engineered holistic paradigm	Fundamental didactic analyzer
Daniel, Ortiz and Balistreri	Balanced maximized hub	Re-engineered grid-enabled circuit
McDermott-Emmerich	Seamless bottom-line complexity	Business-focused bandwidth-monitored frame
Zemlak Group	Virtual tangible functionalities	Distributed intermediate moderator
Connelly and Sons	Stand-alone system-worthy analyzer	User-friendly assymetric knowledge base
D'Amore Group	Switchable holistic ability	Customizable uniform algorithm
Yundt-Rau	Seamless uniform open system	Virtual encompassing model
Batz, Altenwerth and Veum	Team-oriented responsive standardization	Assimilated neutral approach
Hermann, Osinski and Braun	Streamlined intermediate strategy	Robust secondary firmware
Pfeffer Group	Cross-group reciprocal architecture	Extended multi-state data-warehouse
Mann and Sons	Programmable interactive protocol	Cloned coherent moderator
Satterfield and Sons	Centralized transitional projection	Seamless bottom-line service-desk
Jaskolski, Schamberger and Runolfsson	Expanded zero defect internet solution	User-friendly asynchronous orchestration
Gibson, Beatty and Turcotte	Re-contextualized bottom-line data-warehouse	Monitored value-added collaboration
Medhurst-Johnston	Optional value-added concept	Object-based upward-trending array
Jacobson-Haley	Operative dynamic info-mediaries	Compatible zero defect help-desk
Bechtelar Inc	Managed content-based installation	Expanded asynchronous Graphical User Interface
Murphy-Quitzon	Centralized reciprocal support	Open-architected assymetric leverage
Ritchie-King	Managed intangible knowledge base	Diverse discrete solution
Casper LLC	Upgradable intangible framework	Horizontal local core
Prohaska Group	Proactive full-range functionalities	Monitored client-driven knowledge user
Greenfelder, Langosh and Schamberger	Mandatory stable interface	Ergonomic reciprocal parallelism
Terry-Bruen	Reactive asynchronous challenge	Ergonomic holistic protocol
Prosacco, Altenwerth and Huel	Reactive secondary budgetary management	Mandatory directional extranet
Kassulke-Schaden	Polarised context-sensitive pricing structure	Front-line optimal leverage
Larkin, Rohan and Bauch	Innovative system-worthy conglomeration	Digitized didactic projection
Goodwin and Sons	Customer-focused encompassing flexibility	Progressive tangible adapter
Nicolas-Bergnaum	Optional multi-tasking contingency	Ergonomic stable system engine
Schneider, O'Conner and Willms	Team-oriented disintermediate superstructure	Multi-tiered leading edge data-warehouse
Durgan, Kuhlman and Cremin	User-friendly intangible time-frame	Up-sized 24 hour contingency
Trantow, Weber and Tromp	Implemented intangible database	Re-contextualized zero defect structure
Schneider-Mante	Cross-group heuristic superstructure	Mandatory foreground moderator
Casper and Sons	Seamless global capability	Team-oriented 24 hour functionalities
Lockman and Sons	Switchable uniform structure	Public-key logistical secured line
Mraz Group	Triple-buffered systematic hub	Vision-oriented motivating info-mediaries
Baumbach, Lemke and Cremin	Multi-channelled web-enabled definition	Down-sized user-facing conglomeration
Wiegand LLC	Public-key assymetric circuit	Monitored tangible productivity
Russel Group	Business-focused foreground moratorium	Synergized heuristic local area network
Lowe Group	Persistent real-time adapter	Customizable 24 hour project
Cormier and Sons	Extended attitude-oriented adapter	Organized explicit framework
Stracke Inc	Synchronised 5th generation success	Fundamental impactful website
Crooks-Maggio	Profit-focused reciprocal frame	Focused grid-enabled neural-net
Mitchell Inc	Business-focused asynchronous standardization	Ergonomic non-volatile system engine
Smith-McClure	Robust hybrid pricing structure	Front-line optimizing emulation
Schinner, Sanford and Rodriguez	Re-engineered exuding budgetary management	Open-architected systemic collaboration
Rogahn-Goodwin	User-friendly well-modulated architecture	Phased scalable archive
Hermiston, Kerluke and Sauer	Re-engineered system-worthy function	Compatible static matrices
Collins, Schiller and Spencer	Future-proofed optimal firmware	Organic impactful throughput
Jast, Sipes and Sauer	Sharable static middleware	Expanded global leverage
Mohr-Beahan	Compatible bandwidth-monitored Graphic Interface	Fully-configurable bi-directional website
Jast-Kozey	Face to face bifurcated initiative	Inverse needs-based solution
Crooks LLC	Operative motivating firmware	Re-engineered encompassing hardware
Reichel LLC	Exclusive encompassing collaboration	Stand-alone bandwidth-monitored approach
Feil Inc	Enterprise-wide analyzing installation	Optimized clear-thinking monitoring
Gusikowski and Sons	Secured optimal functionalities	Progressive needs-based matrix
Trantow Inc	Multi-channelled responsive synergy	Enhanced explicit support
Orn, Lubowitz and McGlynn	Decentralized user-facing knowledge base	Team-oriented contextually-based encoding
Fahey-Herzog	Vision-oriented attitude-oriented local area network	Compatible zero administration model
Stracke Inc	Multi-tiered fresh-thinking capacity	Secured bifurcated service-desk
Rippin, Halvorson and Schmitt	Profound 24 hour access	Exclusive encompassing data-warehouse
Schinner, Armstrong and Barrows	Streamlined leading edge pricing structure	Cross-group upward-trending application
Nienow, Pouros and Block	Stand-alone asynchronous hub	Networked zero administration Graphical User Interface
Gorczany-Bradtke	Reactive bandwidth-monitored frame	Monitored disintermediate conglomeration
Dicki Inc	Monitored multi-state capability	Advanced attitude-oriented knowledge user
Sawayn, Parker and Conn	Sharable optimizing strategy	User-friendly global Graphical User Interface
Kassulke, Hauck and Collier	Reverse-engineered full-range matrix	Distributed intangible firmware
Wiza-Hilpert	Horizontal zero tolerance project	Public-key 24/7 definition
Berge, Strosin and Smitham	Digitized local flexibility	Diverse asynchronous adapter
Block-Steuber	Multi-tiered multimedia installation	Vision-oriented intermediate budgetary management
Ruecker Inc	Organized actuating middleware	Grass-roots incremental standardization
Rogahn-Turner	Up-sized impactful paradigm	Universal didactic solution
Wilkinson, Homenick and Blanda	Seamless secondary productivity	Optional systemic moratorium
Runte, Stokes and Walter	Visionary cohesive alliance	Multi-layered optimizing frame
Mayer-Beier	Decentralized multimedia forecast	Versatile human-resource approach
Gusikowski-Ullrich	Synergistic content-based paradigm	Optional systematic contingency
Prohaska-Howell	Vision-oriented eco-centric utilisation	Team-oriented holistic data-warehouse
Hackett Inc	Optional fault-tolerant analyzer	Grass-roots incremental artificial intelligence
Harris, Fadel and Schroeder	Cross-group cohesive model	Extended incremental workforce
Boehm LLC	Monitored non-volatile moratorium	Intuitive executive definition
Watsica, Huel and Reinger	Synergized clear-thinking middleware	Expanded stable moratorium
Hermann-Kris	Future-proofed national synergy	Fundamental coherent approach
Waters Group	Compatible tangible array	Enhanced high-level hardware
Goldner, Crona and Gorczany	Phased homogeneous archive	Team-oriented analyzing architecture
Dach-Nitzsche	Progressive methodical firmware	Profound client-driven structure
Bruen, Hessel and Larkin	Intuitive methodical application	Up-sized multi-tasking paradigm
Monahan Inc	Visionary attitude-oriented middleware	Distributed client-server benchmark
Ledner-Boehm	Operative scalable toolset	Fundamental 3rd generation model
Stracke-Stanton	User-friendly homogeneous methodology	Networked impactful artificial intelligence
Lueilwitz and Sons	Universal regional capability	Self-enabling reciprocal strategy
Dach Group	Universal holistic superstructure	Future-proofed contextually-based info-mediaries
Ebert-Powlowski	Polarised context-sensitive neural-net	Mandatory explicit website
Wiegand LLC	Virtual composite matrix	Progressive heuristic hardware
Mohr LLC	Grass-roots fresh-thinking local area network	Switchable upward-trending interface
Wisoky and Sons	Reverse-engineered optimizing installation	Diverse encompassing knowledge user
Lueilwitz, Schuster and Cremin	Configurable interactive alliance	Triple-buffered clear-thinking matrices
Morissette Inc	Expanded eco-centric collaboration	Total regional data-warehouse
Hirthe Group	Multi-lateral radical pricing structure	Integrated cohesive data-warehouse
Schumm Inc	Integrated didactic process improvement	Open-source incremental architecture
Corwin-Durgan	Persistent grid-enabled productivity	Multi-channelled static hub
Monahan-Dooley	Optional attitude-oriented artificial intelligence	Devolved 6th generation customer loyalty
Kemmer Group	Focused multi-state system engine	Total incremental Graphical User Interface
Cartwright Group	Triple-buffered uniform system engine	Operative bifurcated budgetary management
Schmeler, Runolfsdottir and Koch	Profound static framework	Intuitive uniform secured line
Paucek-Spencer	Extended regional attitude	Robust bifurcated architecture
Keeling, Douglas and Bradtke	Re-engineered real-time synergy	Multi-lateral zero administration utilisation
Hansen LLC	User-centric tangible hierarchy	Cloned intangible interface
Spinka and Sons	Phased stable budgetary management	Persevering interactive definition
Hettinger, Kunze and Heaney	Enhanced client-server website	Upgradable full-range internet solution
Gutkowski, Spinka and Keebler	Synchronised mission-critical frame	Business-focused bi-directional data-warehouse
Medhurst-Lynch	Object-based analyzing array	Front-line intangible hub
Kautzer, Tillman and Gaylord	Networked well-modulated model	Monitored 3rd generation Graphic Interface
Rodriguez-O'Reilly	Future-proofed regional infrastructure	Mandatory 5th generation database
Powlowski Group	Persistent uniform algorithm	Universal national standardization
Volkman, Boehm and O'Kon	Front-line transitional implementation	Re-contextualized clear-thinking alliance
Osinski Inc	Expanded contextually-based monitoring	Vision-oriented transitional pricing structure
Lubowitz, Marks and Hills	Synergistic next generation architecture	Re-contextualized system-worthy product
Green and Sons	Public-key web-enabled help-desk	Business-focused attitude-oriented approach
Leffler LLC	Managed user-facing data-warehouse	Open-architected mission-critical parallelism
Gulgowski, Gottlieb and Bode	Digitized zero tolerance superstructure	Cross-group uniform application
Jones-Prohaska	Digitized global process improvement	Persistent multi-tasking middleware
Oberbrunner and Sons	Monitored impactful core	Grass-roots regional product
Mertz-Sporer	Re-engineered directional frame	Networked 4th generation extranet
Lang Group	Triple-buffered leading edge array	Visionary maximized Graphical User Interface
Jacobson-Leffler	Total upward-trending strategy	Realigned analyzing firmware
Hermiston-Davis	Re-contextualized well-modulated policy	Sharable static data-warehouse
Rutherford, Murray and Batz	Exclusive didactic initiative	Exclusive zero administration algorithm
Schumm-Cremin	Multi-lateral zero administration knowledge user	Customer-focused systematic moderator
Dietrich LLC	Diverse attitude-oriented hardware	Right-sized intangible methodology
Walker-Zboncak	Implemented coherent contingency	Open-architected modular attitude
Aufderhar LLC	Re-engineered scalable workforce	Synchronised even-keeled hardware
McLaughlin, Lynch and Lemke	Object-based bifurcated moderator	Ameliorated interactive throughput
Reilly-Marquardt	Extended exuding monitoring	Re-contextualized interactive functionalities
Wintheiser, Barton and Donnelly	Enterprise-wide neutral parallelism	Monitored methodical installation
Jacobs-Dicki	Open-source coherent initiative	Upgradable radical structure
Treutel-McCullough	Open-architected eco-centric forecast	Optimized transitional forecast
Welch-Steuber	Profit-focused dedicated local area network	Persistent intermediate flexibility
Zieme and Sons	User-friendly 4th generation info-mediaries	Organized holistic encryption
Spinka-Reynolds	Focused dedicated customer loyalty	Integrated 6th generation system engine
Kautzer, Rosenbaum and Tremblay	Inverse bottom-line implementation	Configurable multi-state archive
Swift-Bosco	Ergonomic systematic adapter	Reverse-engineered mobile portal
Russel-Welch	Pre-emptive zero tolerance emulation	Switchable attitude-oriented projection
Cremin LLC	Automated incremental moratorium	Expanded asynchronous paradigm
Hayes Inc	Up-sized attitude-oriented application	Horizontal holistic collaboration
Connelly Inc	Monitored bottom-line framework	Multi-tiered content-based matrices
Deckow Inc	Organic optimal challenge	User-centric multi-state collaboration
Hirthe-Marquardt	Expanded solution-oriented extranet	Versatile cohesive secured line
Balistreri-Powlowski	Universal bandwidth-monitored service-desk	Open-source mobile infrastructure
Price, Flatley and Stoltenberg	Fully-configurable modular model	Implemented explicit productivity
Kessler Inc	Managed bottom-line website	Digitized non-volatile hardware
Muller and Sons	Intuitive mobile database	Face to face attitude-oriented matrix
Crist Group	Team-oriented methodical middleware	User-centric assymetric open system
Wiza, Reichel and Waters	Total stable forecast	Universal incremental task-force
Howell-Tromp	Optimized reciprocal concept	Balanced logistical customer loyalty
Sipes, Gerhold and Lehner	Profit-focused maximized product	Organized eco-centric artificial intelligence
Ankunding-Brown	Configurable global protocol	Customer-focused optimal help-desk
Ernser LLC	Pre-emptive exuding infrastructure	Pre-emptive regional collaboration
Doyle, Heaney and Kshlerin	Synchronised motivating application	Re-contextualized tangible success
Orn Inc	Intuitive radical task-force	Universal non-volatile alliance
Halvorson, Rowe and Heidenreich	Future-proofed intermediate architecture	Reverse-engineered global internet solution
O'Reilly, Zemlak and Legros	Cross-platform systemic capacity	Switchable intangible system engine
Lynch, Brown and Fritsch	Profit-focused radical neural-net	Operative systemic instruction set
Barton-Spencer	Function-based background capacity	Cloned actuating function
Fisher-Pagac	Operative system-worthy intranet	User-friendly 3rd generation moratorium
Rempel, Kub and Champlin	Team-oriented heuristic collaboration	Triple-buffered well-modulated framework
Hagenes-Zboncak	Quality-focused disintermediate task-force	Synergized well-modulated initiative
Robel-Lakin	Devolved high-level encryption	Configurable human-resource budgetary management
Wilkinson Inc	Profound radical help-desk	Right-sized background data-warehouse
Kreiger-Hahn	Centralized human-resource implementation	Devolved optimizing database
Bosco-Spinka	User-friendly assymetric portal	Organized uniform contingency
Leuschke, Barton and Jacobi	Inverse real-time structure	Distributed solution-oriented function
Schmeler-Williamson	Up-sized upward-trending definition	Proactive real-time orchestration
Botsford, Gutkowski and Williamson	User-friendly 24/7 focus group	Profound didactic database
Harber LLC	Upgradable grid-enabled protocol	Integrated fresh-thinking solution
Heidenreich Inc	Digitized radical model	Phased value-added definition
Marquardt Group	Up-sized leading edge process improvement	Multi-lateral client-driven info-mediaries
Powlowski and Sons	Implemented 5th generation flexibility	Open-architected background budgetary management
Ritchie, Kshlerin and Schumm	Seamless object-oriented monitoring	Open-source real-time time-frame
Wilkinson-Parisian	Total web-enabled customer loyalty	Integrated background utilisation
Lubowitz, Hartmann and Walker	Synergistic intangible moderator	Triple-buffered radical forecast
Cartwright, Marvin and Beahan	User-centric foreground parallelism	Upgradable client-driven collaboration
Carroll-Dietrich	Fully-configurable encompassing function	Reactive radical process improvement
Shanahan Group	Persistent 5th generation archive	Universal 24/7 groupware
Upton Inc	Realigned dynamic pricing structure	Persevering local collaboration
Block Inc	Phased regional benchmark	Configurable 4th generation migration
Durgan LLC	Programmable scalable neural-net	Extended hybrid help-desk
Lind-Gusikowski	Open-source hybrid approach	Mandatory assymetric installation
Stiedemann, Lebsack and Hartmann	Virtual dynamic task-force	Grass-roots optimizing workforce
McGlynn-Considine	Networked explicit groupware	Persevering local benchmark
Medhurst and Sons	Synchronised transitional process improvement	Intuitive composite benchmark
Littel, Cummings and Morar	Fundamental well-modulated local area network	Ameliorated methodical emulation
Berge, Goldner and Raynor	User-friendly intermediate benchmark	Cross-group mission-critical core
Bauch Group	Multi-lateral bottom-line encoding	Synergistic national migration
O'Conner, Robel and Gerhold	Monitored directional model	Profound multi-state circuit
Schmidt LLC	Future-proofed methodical knowledge user	Stand-alone motivating internet solution
Considine-Rippin	Function-based homogeneous moderator	Advanced 5th generation installation
Lind and Sons	Integrated clear-thinking pricing structure	Automated system-worthy support
Doyle LLC	Programmable web-enabled parallelism	Customer-focused bifurcated open architecture
Johnson, Block and Abshire	Synchronised uniform groupware	Compatible contextually-based hub
Koepp-Schimmel	Implemented transitional orchestration	Customer-focused scalable support
Hand-Barton	Multi-layered dynamic system engine	Horizontal fault-tolerant help-desk
Grady-Gislason	Integrated uniform website	Fully-configurable modular pricing structure
Kreiger LLC	Cross-group optimizing projection	Streamlined intermediate intranet
Dach-Huels	Face to face 24/7 superstructure	Synergized content-based parallelism
Sporer-Auer	Face to face bi-directional product	Switchable neutral project
Bergnaum, Hand and Schuppe	Networked human-resource toolset	Polarised foreground alliance
Harris-Koepp	Universal tangible challenge	Multi-channelled responsive leverage
Willms Group	Diverse motivating groupware	Networked zero administration analyzer
Dach, Vandervort and Adams	Pre-emptive uniform Graphical User Interface	User-friendly systemic data-warehouse
Klein, Strosin and Kuphal	Visionary web-enabled open architecture	Multi-lateral mobile emulation
Champlin Group	Reactive attitude-oriented emulation	User-centric foreground knowledge base
Blanda and Sons	Proactive demand-driven collaboration	Managed non-volatile solution
Spencer and Sons	Function-based multi-tasking support	De-engineered assymetric encryption
Stamm and Sons	Enhanced optimal leverage	Self-enabling bottom-line secured line
Strosin-Bradtke	Networked well-modulated policy	Up-sized optimizing Graphical User Interface
Grady, Koepp and Orn	Secured logistical application	Monitored optimal encoding
Hirthe-Mayert	Reduced systematic capacity	Automated explicit attitude
Weber, Bruen and Bode	Profound 24 hour project	Business-focused 4th generation attitude
Labadie-Sporer	User-centric disintermediate synergy	Up-sized user-facing installation
Schultz-Schuppe	Public-key heuristic Graphic Interface	Profit-focused didactic attitude
Williamson Inc	User-centric solution-oriented encryption	Realigned national extranet
Bayer Inc	Reduced dynamic neural-net	Balanced stable initiative
Maggio and Sons	Reverse-engineered contextually-based hierarchy	Advanced 4th generation concept
Kuhic-Mertz	Centralized multi-tasking encoding	Virtual intermediate emulation
Buckridge LLC	Advanced actuating intranet	Triple-buffered actuating intranet
Gerlach-Towne	Cross-platform hybrid open architecture	Business-focused 6th generation methodology
Hand-Ziemann	Operative mission-critical flexibility	Profound empowering installation
Jacobs LLC	Optimized holistic open architecture	Expanded analyzing challenge
Bahringer LLC	Assimilated discrete concept	Switchable stable analyzer
Gutkowski Inc	Multi-lateral dynamic knowledge base	Versatile analyzing interface
Lindgren-Osinski	Secured 3rd generation array	Future-proofed demand-driven workforce
Schuster Inc	Right-sized 24/7 methodology	Expanded stable projection
Hammes, Kris and Muller	Realigned local access	Synergized system-worthy array
Borer-Schumm	Monitored didactic service-desk	Expanded system-worthy hub
Schowalter-Deckow	Profit-focused system-worthy archive	Synergistic content-based adapter
Stracke and Sons	Versatile tangible matrix	Centralized client-server instruction set
Robel LLC	Monitored zero administration Graphic Interface	Synergized tertiary function
Gusikowski, Adams and Gibson	Reactive fault-tolerant functionalities	Diverse value-added adapter
Morissette LLC	Diverse zero tolerance complexity	Object-based encompassing capability
Sporer, Hirthe and Dare	Re-contextualized global project	Quality-focused 6th generation moderator
Fisher-Cartwright	Managed intermediate matrices	Managed intermediate data-warehouse
Klocko-Kilback	Managed multi-tasking contingency	User-friendly stable customer loyalty
Green, Schowalter and Schumm	Right-sized clear-thinking functionalities	Proactive dynamic methodology
Breitenberg Group	Function-based 3rd generation frame	Profit-focused 24 hour frame
Mosciski, Dare and Tremblay	Team-oriented regional customer loyalty	Total stable matrix
Luettgen Group	Multi-layered attitude-oriented middleware	Realigned interactive orchestration
Watsica, Champlin and Price	Optimized fault-tolerant workforce	Object-based non-volatile framework
Oberbrunner, Hayes and Reilly	Focused cohesive success	Versatile cohesive flexibility
Kirlin, Emard and Dickens	Profit-focused 5th generation firmware	Down-sized demand-driven definition
Murphy-Beatty	Operative solution-oriented complexity	Streamlined multi-state installation
Lind and Sons	Self-enabling motivating local area network	Robust encompassing monitoring
Jacobi-Schaden	Universal contextually-based hardware	Assimilated solution-oriented superstructure
Casper, Schowalter and Streich	Streamlined multi-tasking access	Advanced non-volatile extranet
Beahan-Ebert	Quality-focused bandwidth-monitored internet solution	Optional cohesive budgetary management
Greenfelder Group	Open-architected even-keeled knowledge user	Stand-alone client-server workforce
Hoppe and Sons	Pre-emptive high-level support	Organic intangible workforce
Keebler Group	Multi-lateral impactful success	Realigned stable core
Waters, Wolf and Gorczany	Monitored discrete capability	Assimilated disintermediate orchestration
Rath-Harber	De-engineered next generation circuit	Exclusive analyzing parallelism
Lesch-Schmitt	Front-line assymetric system engine	Open-architected user-facing methodology
Hudson-Schaden	Business-focused bottom-line support	Adaptive actuating core
Lynch-Pacocha	Secured zero tolerance flexibility	Assimilated impactful capability
Weber Inc	Vision-oriented value-added standardization	Customizable 5th generation time-frame
Bailey-Lesch	Enterprise-wide fault-tolerant attitude	Fully-configurable scalable approach
Cartwright-Weissnat	Multi-tiered even-keeled infrastructure	Secured bandwidth-monitored open system
Boyle LLC	Multi-lateral human-resource system engine	Phased non-volatile emulation
Mitchell, Tremblay and Dicki	Organized zero tolerance initiative	Triple-buffered attitude-oriented array
Ebert and Sons	Persistent multimedia moratorium	Stand-alone value-added artificial intelligence
Pollich and Sons	Centralized human-resource concept	Profound systemic interface
Moore-Considine	Horizontal radical protocol	Progressive cohesive open system
Oberbrunner, Legros and Weissnat	Monitored mission-critical neural-net	User-centric explicit capability
D'Amore Group	Enhanced tangible installation	Inverse analyzing instruction set
Gusikowski-Harris	Enterprise-wide full-range challenge	Fundamental modular migration
Koelpin Inc	Re-engineered clear-thinking forecast	Open-source next generation migration
Hayes LLC	Assimilated bottom-line portal	Re-contextualized cohesive benchmark
Blanda, Yost and Weber	Mandatory non-volatile local area network	Intuitive multi-tasking implementation
D'Amore, Shanahan and Sporer	Public-key interactive strategy	Enhanced tangible initiative
Kling, Pfannerstill and Stamm	Triple-buffered content-based array	Balanced zero administration internet solution
Nikolaus and Sons	Profit-focused assymetric orchestration	Re-contextualized systemic framework
Marvin-Runolfsson	Face to face bottom-line paradigm	Organized coherent concept
Williamson Group	Fully-configurable national projection	Intuitive secondary pricing structure
Spinka Group	Operative scalable emulation	Organic bandwidth-monitored throughput
Bode, Willms and Durgan	Compatible multi-tasking archive	Centralized demand-driven database
Keeling Inc	Triple-buffered mission-critical software	Switchable uniform utilisation
Tromp-Crooks	Synchronised asynchronous monitoring	Profound high-level implementation
Cummings, Kohler and Boyer	Reduced clear-thinking implementation	Mandatory 4th generation firmware
Sauer-Schamberger	Realigned real-time database	Sharable exuding open architecture
Hegmann Inc	Cloned dedicated toolset	Managed analyzing challenge
Gulgowski-Robel	Open-architected optimal matrix	Monitored responsive software
Skiles LLC	Multi-layered cohesive task-force	Progressive object-oriented intranet
Ritchie-Muller	Grass-roots cohesive monitoring	Exclusive maximized budgetary management
Bednar, Erdman and Donnelly	De-engineered object-oriented functionalities	Integrated user-facing open system
Schumm-Heller	Digitized radical capability	Centralized human-resource firmware
Spencer-Stamm	Universal clear-thinking firmware	Robust multimedia framework
Harris Group	Synchronised neutral functionalities	Streamlined object-oriented concept
Schamberger, McCullough and Wolff	Triple-buffered national alliance	Persevering impactful policy
Pfannerstill, Abernathy and Dietrich	Fully-configurable even-keeled service-desk	Quality-focused fault-tolerant hardware
Olson-Harris	Switchable analyzing toolset	Versatile scalable utilisation
Johnson-Johnson	Fully-configurable holistic budgetary management	Down-sized explicit support
Wolf and Sons	Secured systematic model	Stand-alone optimal focus group
Bednar Inc	User-centric systematic hardware	Optimized value-added throughput
Kertzmann-Bartell	Open-source human-resource access	Implemented interactive standardization
Yost, Corkery and Maggio	Front-line local array	Multi-channelled explicit product
Kling, Graham and Konopelski	Programmable exuding local area network	Public-key dynamic time-frame
Donnelly LLC	Ergonomic bottom-line strategy	Decentralized multi-tasking initiative
Nicolas Inc	Vision-oriented multi-state methodology	User-centric real-time model
Hickle-Brakus	Progressive eco-centric benchmark	Open-architected client-server implementation
Davis LLC	Organic dedicated encryption	Configurable systemic functionalities
Casper Inc	Multi-tiered tertiary access	Stand-alone non-volatile approach
Walter LLC	Assimilated scalable conglomeration	Customer-focused dynamic instruction set
Fritsch-Rice	Cloned even-keeled customer loyalty	Down-sized real-time contingency
Rohan-VonRueden	Adaptive systematic instruction set	Ameliorated 4th generation standardization
Willms, Wunsch and Harber	Total client-driven neural-net	Balanced mobile parallelism
Lind-Klocko	Secured logistical capability	Distributed client-driven help-desk
Rutherford, Considine and Beahan	Switchable client-server encryption	Streamlined bottom-line knowledge base
Pollich-Senger	Organized local pricing structure	Synergistic discrete moratorium
Homenick-Watsica	Persistent 5th generation service-desk	Future-proofed fresh-thinking instruction set
Schumm and Sons	Total local projection	Synergistic asynchronous circuit
Simonis, Hyatt and Kilback	Programmable client-server software	Persistent fault-tolerant encryption
Predovic-Kiehn	Cross-group incremental policy	Fundamental demand-driven contingency
Flatley and Sons	Sharable 24/7 success	Total systematic challenge
Littel and Sons	Distributed motivating ability	Automated radical conglomeration
Mitchell Group	Adaptive attitude-oriented intranet	Up-sized attitude-oriented parallelism
Schultz-Mayer	Innovative client-server parallelism	Assimilated grid-enabled utilisation
Langworth Inc	Compatible real-time model	Optional disintermediate solution
Morar-Powlowski	Compatible dedicated orchestration	Configurable methodical local area network
Bosco LLC	Decentralized dynamic synergy	Cloned incremental structure
Runolfsson Inc	Programmable next generation framework	Balanced real-time architecture
Gleason Group	Multi-lateral optimizing array	Organic needs-based standardization
Gerlach-Abernathy	Total 5th generation data-warehouse	Advanced web-enabled frame
Wiegand Inc	Visionary impactful structure	Digitized coherent circuit
DuBuque Group	Multi-tiered human-resource archive	Profound content-based adapter
Reichel-Spencer	Extended 24 hour architecture	Devolved attitude-oriented database
Morar LLC	Object-based 24 hour hardware	Re-contextualized optimizing array
Heaney, Larson and McCullough	Up-sized responsive synergy	Reduced scalable intranet
Glover-O'Keefe	Team-oriented mission-critical collaboration	Optional dedicated firmware
Miller-Champlin	Versatile exuding migration	Universal dynamic capacity
Spencer, Denesik and Mills	Networked analyzing hub	Multi-tiered content-based customer loyalty
Quigley, Bauch and Leffler	Managed fault-tolerant conglomeration	Cross-group fault-tolerant data-warehouse
Bosco-Jerde	Vision-oriented reciprocal matrix	Multi-lateral 3rd generation artificial intelligence
Watsica-Bednar	Centralized needs-based time-frame	Future-proofed regional local area network
Goodwin, Schulist and Bruen	Visionary background architecture	Self-enabling directional groupware
Denesik, Lind and Reynolds	Managed heuristic knowledge user	Persevering directional leverage
Predovic LLC	Profit-focused motivating artificial intelligence	Realigned stable paradigm
West Group	Proactive responsive hardware	Pre-emptive web-enabled help-desk
Koepp Group	Organized 3rd generation function	Fully-configurable contextually-based secured line
Jacobson, Sporer and O'Reilly	Right-sized radical open system	Multi-tiered content-based open system
Connelly-Abbott	Horizontal multi-tasking product	Cross-group stable policy
Heaney and Sons	Devolved discrete orchestration	Triple-buffered asynchronous access
O'Connell and Sons	Exclusive asynchronous secured line	Devolved well-modulated superstructure
Douglas-Beier	Re-contextualized upward-trending matrices	Open-architected client-server adapter
King-Hansen	User-friendly next generation capacity	Object-based stable knowledge base
Douglas-Anderson	Synergized high-level workforce	Horizontal object-oriented service-desk
Lehner, Powlowski and Connelly	Decentralized context-sensitive attitude	Streamlined object-oriented knowledge user
Herman-Jewess	Advanced bottom-line capacity	User-friendly multi-state secured line
Kozey Inc	Operative heuristic Graphical User Interface	Optional local middleware
Collins, Hodkiewicz and D'Amore	Vision-oriented coherent hub	Quality-focused next generation Graphical User Interface
Abshire and Sons	Balanced demand-driven middleware	Sharable maximized approach
Deckow, Stamm and Fisher	De-engineered systemic analyzer	Grass-roots content-based installation
Mertz LLC	Visionary foreground help-desk	Re-engineered bottom-line contingency
Altenwerth-Grady	Synergistic multimedia service-desk	Focused upward-trending definition
Auer-Runolfsdottir	Extended responsive database	Realigned global parallelism
Donnelly LLC	Reverse-engineered uniform strategy	Automated client-driven system engine
Roberts LLC	Programmable interactive workforce	Future-proofed actuating core
Labadie, Sauer and Wintheiser	Open-architected eco-centric process improvement	Distributed actuating process improvement
Bogisich and Sons	Operative asynchronous application	Multi-channelled solution-oriented analyzer
Fadel, Koch and Shields	Sharable analyzing archive	Open-architected national capability
Bechtelar and Sons	Re-engineered zero defect concept	Up-sized attitude-oriented help-desk
Upton, Schiller and Wisozk	Reactive multi-state encryption	User-friendly systemic encoding
Dickinson, Smith and Herzog	Mandatory optimizing circuit	Monitored national application
Pollich, Turner and DuBuque	Future-proofed tertiary intranet	Customizable analyzing success
Waters-Bechtelar	Advanced multimedia utilisation	Ameliorated contextually-based matrices
Huels, Schumm and Torp	Multi-tiered zero tolerance challenge	Business-focused global benchmark
O'Conner and Sons	Cloned non-volatile model	Multi-tiered encompassing capability
Gulgowski, O'Kon and Stanton	Expanded bifurcated hierarchy	Right-sized explicit array
Veum LLC	Integrated clear-thinking array	Managed web-enabled throughput
Hammes, Raynor and Cummings	Customizable analyzing open system	Integrated eco-centric solution
Orn-Leuschke	Advanced coherent contingency	User-centric motivating project
Satterfield Inc	Expanded didactic neural-net	Distributed reciprocal leverage
Kozey Inc	Total background encoding	Up-sized executive utilisation
Brakus Group	Team-oriented neutral circuit	Balanced impactful challenge
Reynolds and Sons	Function-based explicit paradigm	Secured object-oriented complexity
Hartmann LLC	Fully-configurable bottom-line circuit	Triple-buffered actuating migration
Kuhic-Gutmann	Cross-group even-keeled process improvement	Proactive neutral model
Keeling and Sons	Horizontal 24/7 initiative	Intuitive multimedia parallelism
Ward, Hackett and D'Amore	Down-sized stable interface	User-friendly grid-enabled monitoring
Gorczany-Koch	Robust modular framework	Monitored bandwidth-monitored structure
O'Kon, Treutel and Walsh	Horizontal content-based adapter	Multi-tiered user-facing pricing structure
Schimmel LLC	Seamless human-resource emulation	Digitized analyzing artificial intelligence
Morar LLC	Optional actuating leverage	Right-sized maximized capacity
Kemmer-Macejkovic	Versatile cohesive groupware	Enhanced exuding benchmark
Murphy-Mills	Reverse-engineered national matrices	Focused systematic standardization
Wilkinson-Corwin	Reverse-engineered next generation methodology	Versatile heuristic productivity
Cartwright-Grimes	Optional uniform open architecture	Horizontal attitude-oriented parallelism
Swift Group	Polarised transitional productivity	Diverse fault-tolerant algorithm
Mraz Group	Digitized static monitoring	Inverse maximized capability
Wisoky, Harvey and Shields	Total responsive leverage	Reactive multi-state conglomeration
West Inc	Configurable next generation orchestration	Reverse-engineered human-resource Graphic Interface
Lubowitz and Sons	Ameliorated tangible local area network	Mandatory neutral challenge
McDermott, Strosin and Lindgren	Devolved value-added workforce	Re-contextualized 5th generation strategy
Funk-Konopelski	Reduced bottom-line success	Open-source 6th generation open system
McKenzie Group	Switchable foreground adapter	Quality-focused reciprocal open architecture
Harvey-Herman	Business-focused analyzing methodology	Organic context-sensitive orchestration
Jewess-Waters	Public-key reciprocal standardization	Fundamental didactic superstructure
Schuppe-Koepp	Enhanced multimedia forecast	Centralized bifurcated website
Wilderman-Spinka	Re-contextualized regional definition	Streamlined impactful budgetary management
Upton Group	Exclusive global service-desk	Stand-alone static local area network
Bergstrom, Luettgen and Tromp	Ameliorated didactic methodology	Persevering mission-critical knowledge user
Champlin and Sons	Balanced actuating hardware	Polarised systematic project
Grant, Bruen and Schinner	Fully-configurable national function	Ergonomic context-sensitive moratorium
Gottlieb Group	Monitored value-added forecast	Versatile executive help-desk
Durgan-Cole	Up-sized foreground attitude	Business-focused encompassing product
Oberbrunner, Zemlak and Romaguera	Assimilated secondary toolset	Sharable homogeneous synergy
Waters, Howe and Nienow	Operative contextually-based solution	Reactive dynamic protocol
Gutkowski Group	Phased maximized migration	Managed fresh-thinking knowledge user
Gulgowski LLC	Object-based zero tolerance forecast	Streamlined tertiary encoding
Reynolds-Prosacco	Organized transitional paradigm	Enterprise-wide cohesive success
Sporer, Maggio and Douglas	Enhanced asynchronous circuit	Managed global pricing structure
Schuster, Pouros and Thompson	Assimilated zero administration instruction set	Advanced foreground forecast
DuBuque-Gottlieb	Open-architected modular internet solution	Pre-emptive heuristic model
McDermott and Sons	Progressive local customer loyalty	Multi-channelled object-oriented archive
Jewess, Heidenreich and Lebsack	Phased didactic migration	Reactive dedicated initiative
Nolan and Sons	Persevering zero tolerance hub	Down-sized homogeneous service-desk
Feest LLC	Universal local website	Stand-alone dynamic solution
Ryan, Stoltenberg and Hilpert	Visionary regional array	Managed systemic flexibility
Ziemann Group	Automated static emulation	Versatile motivating paradigm
Hodkiewicz, Heller and Blick	Reduced tangible budgetary management	Re-contextualized 24 hour algorithm
Blanda, Schaden and Kuphal	User-friendly content-based process improvement	Re-contextualized tangible data-warehouse
Sawayn and Sons	Reverse-engineered exuding analyzer	Intuitive optimal toolset
Barton-Stamm	Fundamental homogeneous intranet	Down-sized bi-directional contingency
Quitzon Inc	Cloned explicit groupware	Sharable background access
Cummerata, Pfannerstill and Krajcik	Open-architected uniform system engine	Down-sized grid-enabled alliance
Gerlach-Ruecker	Reduced discrete product	Persevering full-range secured line
McClure, Huel and Glover	Virtual zero administration capability	Persistent user-facing capacity
Turner, Lindgren and Labadie	Open-architected regional Graphic Interface	Seamless optimal complexity
Stoltenberg, Gorczany and Bahringer	Intuitive clear-thinking matrix	User-friendly disintermediate website
Rodriguez, Heidenreich and Reinger	Face to face non-volatile function	Triple-buffered responsive forecast
Quigley Group	Visionary value-added firmware	Synergistic contextually-based encryption
Kihn-Douglas	Polarised demand-driven time-frame	Digitized encompassing benchmark
Senger-Pfannerstill	Open-architected cohesive Graphic Interface	Future-proofed interactive orchestration
Upton-Turcotte	Total bifurcated orchestration	Up-sized heuristic superstructure
Flatley, Treutel and Buckridge	Digitized high-level customer loyalty	Centralized well-modulated interface
Bradtke Group	Enhanced systemic success	Optional logistical system engine
McKenzie LLC	Switchable asynchronous workforce	Open-source global task-force
Murazik and Sons	Function-based clear-thinking protocol	Right-sized 6th generation core
Howe LLC	Persevering explicit leverage	Pre-emptive next generation customer loyalty
Schumm, Schamberger and Marvin	Profit-focused asynchronous challenge	Face to face object-oriented concept
Bauch Group	Integrated background orchestration	Proactive motivating hardware
McClure, Trantow and Veum	Horizontal next generation analyzer	Front-line web-enabled array
Jacobs LLC	Synchronised foreground synergy	Universal user-facing infrastructure
Dickinson-Sporer	Distributed intermediate open system	User-centric eco-centric internet solution
Aufderhar and Sons	Polarised regional migration	Quality-focused intermediate customer loyalty
McClure, Ferry and Abernathy	Business-focused bifurcated neural-net	Object-based upward-trending Graphical User Interface
Hilpert, Barton and Satterfield	Proactive exuding project	Balanced systemic intranet
Hahn LLC	Future-proofed high-level challenge	Synchronised solution-oriented Graphical User Interface
Brekke-Larson	Seamless bi-directional system engine	Managed well-modulated emulation
Tromp-Sawayn	Progressive fresh-thinking instruction set	Networked upward-trending projection
Feil and Sons	De-engineered bi-directional migration	Re-engineered upward-trending definition
Gislason, Rice and Zemlak	Realigned user-facing interface	Distributed analyzing portal
Torphy-Rice	Face to face radical artificial intelligence	Pre-emptive directional archive
Ankunding, Wilderman and Labadie	Multi-channelled bandwidth-monitored intranet	Up-sized hybrid flexibility
Kling Group	Automated heuristic workforce	Organic 4th generation monitoring
Bashirian, Marquardt and Hackett	Open-source attitude-oriented core	Front-line impactful utilisation
Turner Inc	Networked zero tolerance projection	Multi-channelled fresh-thinking toolset
Hahn Inc	Multi-layered reciprocal archive	Persevering mission-critical approach
Veum, Bogisich and Hilpert	Re-engineered human-resource conglomeration	Fundamental empowering open architecture
Satterfield-Streich	Integrated local data-warehouse	Assimilated maximized interface
Pfeffer-Cassin	Programmable human-resource open architecture	Managed zero defect protocol
Reilly-Stanton	Visionary asynchronous concept	Cross-group bi-directional Graphic Interface
Monahan, Kemmer and Hamill	User-friendly clear-thinking knowledge user	Diverse local moderator
Feeney-Orn	Up-sized national help-desk	Devolved analyzing data-warehouse
Strosin-Kiehn	Cloned upward-trending definition	Decentralized multimedia focus group
Berge Inc	Multi-channelled stable frame	Advanced leading edge secured line
Murray-Rolfson	Progressive analyzing instruction set	Intuitive solution-oriented local area network
Murphy and Sons	Pre-emptive scalable paradigm	Synergistic fault-tolerant toolset
Koepp Inc	Multi-lateral maximized software	Progressive 6th generation complexity
Wolf, Bailey and Carter	Multi-lateral static interface	Multi-tiered executive flexibility
Jaskolski-Green	Multi-layered composite monitoring	Configurable next generation middleware
Klein-Lueilwitz	Universal dedicated budgetary management	Object-based static interface
Franecki and Sons	Fully-configurable exuding knowledge user	Mandatory high-level focus group
O'Conner, Casper and Kemmer	Re-contextualized global throughput	User-friendly static local area network
Rau-Streich	Visionary local secured line	Advanced human-resource installation
Wiegand-Spinka	Automated value-added instruction set	De-engineered didactic artificial intelligence
Hickle-Cormier	Expanded neutral product	Adaptive bottom-line methodology
Tromp-Mraz	Devolved homogeneous success	Grass-roots bandwidth-monitored pricing structure
Feil-Dickinson	Managed bottom-line open architecture	Total systemic conglomeration
Kessler Group	Universal 4th generation instruction set	Polarised system-worthy implementation
Fisher Inc	Public-key grid-enabled local area network	Vision-oriented real-time solution
Fahey-Steuber	Future-proofed dynamic monitoring	Organic executive migration
Bernhard and Sons	Balanced dynamic structure	Mandatory maximized instruction set
Konopelski Inc	Enhanced systematic circuit	Secured systemic model
Wehner LLC	Phased solution-oriented customer loyalty	Assimilated empowering collaboration
Kessler-Spencer	Adaptive logistical installation	Function-based multi-state success
Monahan Inc	Stand-alone modular matrix	Public-key asynchronous portal
Bergnaum, Ondricka and Runte	Multi-lateral client-server analyzer	Phased responsive capacity
Flatley and Sons	Universal logistical application	Polarised assymetric conglomeration
Mayer, Johns and Runolfsson	Extended full-range hierarchy	Profit-focused secondary website
Hintz, Beier and Brekke	Robust zero defect superstructure	Organized value-added info-mediaries
Conroy and Sons	Secured neutral Graphical User Interface	Realigned tangible database
Batz Inc	Total tertiary project	Vision-oriented tangible hierarchy
Ortiz-Connelly	Implemented multi-tasking info-mediaries	Triple-buffered stable system engine
Hane-Boyer	Cross-platform high-level archive	Reverse-engineered explicit utilisation
Lang, Christiansen and Jast	Progressive interactive infrastructure	Stand-alone contextually-based alliance
Hermiston-Trantow	Enhanced system-worthy access	Decentralized client-driven core
Hamill-Beier	Fully-configurable value-added hierarchy	Re-contextualized leading edge model
Ondricka and Sons	Inverse multi-state neural-net	Fundamental neutral customer loyalty
Jones, Prohaska and Bashirian	Fundamental 5th generation website	Persevering asynchronous orchestration
Rutherford-Howell	Profound non-volatile capacity	Implemented optimizing function
Feeney, Harvey and Cartwright	Advanced 24 hour encryption	Ameliorated methodical emulation
Beahan-Wolff	Inverse dynamic pricing structure	Balanced demand-driven emulation
Satterfield-Braun	Proactive fault-tolerant superstructure	Intuitive intermediate model
O'Reilly-Welch	Robust reciprocal groupware	Stand-alone leading edge orchestration
Hoppe-Osinski	User-friendly bi-directional installation	Enhanced impactful info-mediaries
Gerhold-O'Connell	Automated static moratorium	Managed multi-state policy
Doyle, Ebert and Ebert	Open-architected client-driven methodology	Vision-oriented dynamic portal
Streich-Marks	Advanced modular customer loyalty	Intuitive composite knowledge base
Ferry, Douglas and Wintheiser	Programmable object-oriented superstructure	Configurable methodical time-frame
Wolf LLC	Sharable non-volatile policy	Grass-roots homogeneous archive
Sauer, Barrows and Witting	Realigned homogeneous productivity	Sharable holistic algorithm
Ferry-Christiansen	Multi-lateral interactive protocol	Configurable full-range knowledge user
Ratke, Greenfelder and Willms	Vision-oriented modular alliance	Implemented maximized emulation
Wiegand Inc	Fully-configurable 4th generation methodology	Self-enabling methodical project
Stoltenberg, Morar and Heathcote	Advanced maximized open system	Fundamental cohesive model
Beatty, Ondricka and Gaylord	Business-focused tertiary leverage	Intuitive directional methodology
Dooley and Sons	Open-architected logistical encoding	Innovative foreground projection
Treutel Group	Versatile uniform pricing structure	Versatile attitude-oriented definition
Gusikowski Group	Open-source tangible algorithm	User-friendly local capability
Hand-Stiedemann	Implemented user-facing utilisation	Enterprise-wide solution-oriented methodology
Wiza-Stoltenberg	Secured scalable instruction set	Customizable tertiary encoding
Cummings-Boyer	User-centric client-server instruction set	Grass-roots responsive contingency
Runolfsson, Flatley and Smitham	Synergistic even-keeled model	Team-oriented empowering throughput
Davis, Paucek and Toy	Self-enabling 24/7 attitude	Streamlined solution-oriented algorithm
Parker, Lowe and Cremin	Proactive tertiary local area network	Innovative multi-state initiative
Lubowitz and Sons	Up-sized regional array	Business-focused user-facing throughput
Batz-Sipes	Customizable modular functionalities	Persevering fault-tolerant function
Kozey, Schaefer and Gibson	Function-based full-range matrix	Object-based asynchronous focus group
Pfannerstill, Adams and Hayes	Adaptive context-sensitive archive	Business-focused dedicated core
Tromp Group	Upgradable demand-driven concept	User-centric national process improvement
Eichmann-Metz	Optional grid-enabled throughput	Synchronised incremental budgetary management
Donnelly-Parisian	Team-oriented composite emulation	Ameliorated well-modulated array
Jewess-Kreiger	Front-line disintermediate success	Profit-focused empowering customer loyalty
Dicki, Schneider and Kulas	Re-contextualized foreground orchestration	Triple-buffered analyzing support
Klein-Kuhic	Advanced intangible alliance	Virtual fresh-thinking pricing structure
Hyatt, Cole and Beatty	Automated explicit monitoring	Optimized multi-tasking product
O'Connell LLC	Re-engineered 4th generation complexity	Synchronised cohesive alliance
Kovacek Group	Compatible interactive info-mediaries	Vision-oriented 24/7 projection
Volkman-Morar	Open-architected zero defect forecast	Customer-focused systemic orchestration
Gleason-Satterfield	Synergistic user-facing implementation	Automated bottom-line instruction set
Green LLC	Multi-lateral optimal artificial intelligence	Grass-roots composite website
Shields LLC	Phased intangible model	Optimized exuding access
Sporer-Quigley	Seamless reciprocal frame	Virtual neutral intranet
Feest-Greenholt	Front-line bifurcated model	Implemented secondary hub
Cummings Inc	Reduced full-range success	Up-sized systemic budgetary management
Gislason Group	Multi-tiered regional instruction set	Quality-focused modular framework
Morar-Jenkins	Self-enabling client-driven encoding	Organic clear-thinking help-desk
Kerluke, Williamson and Batz	Multi-lateral zero tolerance array	Stand-alone uniform moderator
Streich-Abbott	Optimized uniform contingency	Future-proofed systemic forecast
Grant LLC	Reverse-engineered systemic benchmark	Multi-layered system-worthy analyzer
Keeling LLC	Stand-alone composite workforce	Proactive responsive intranet
Brekke and Sons	Programmable composite productivity	Networked assymetric conglomeration
Harber, Bode and Hahn	Multi-channelled modular Graphic Interface	Robust zero defect pricing structure
Carter Group	Universal intermediate projection	Persevering tertiary system engine
Weimann, Hirthe and Halvorson	Robust cohesive groupware	Cloned encompassing firmware
Hackett, Metz and Bosco	Up-sized bifurcated function	Multi-layered scalable matrices
Emmerich LLC	Digitized multi-state core	Stand-alone optimizing archive
Brekke and Sons	Public-key transitional synergy	Self-enabling cohesive focus group
Ryan-Glover	Multi-layered incremental synergy	Advanced heuristic encoding
Crona, Dickens and Keebler	Managed foreground time-frame	Monitored well-modulated concept
Veum LLC	Exclusive homogeneous success	Customizable fresh-thinking software
Funk, Runolfsdottir and Ruecker	Cross-group user-facing challenge	Ameliorated global model
Schulist-Kautzer	Self-enabling system-worthy adapter	Horizontal methodical open architecture
Ondricka LLC	Seamless grid-enabled policy	Phased 5th generation frame
Bayer, Heller and Bode	Centralized reciprocal archive	Function-based secondary framework
Heller, Tillman and Will	Customer-focused national capability	Reduced hybrid utilisation
Friesen, Cronin and Grant	Cross-platform dynamic Graphic Interface	Mandatory demand-driven benchmark
Mayert LLC	Monitored bi-directional focus group	Profit-focused system-worthy hub
Sauer, Runolfsdottir and Kiehn	Diverse interactive project	Re-contextualized analyzing model
Thompson LLC	Synergized zero defect challenge	Object-based directional knowledge base
McGlynn and Sons	Customizable demand-driven core	Centralized needs-based definition
Wunsch, Donnelly and Weimann	Future-proofed 24/7 paradigm	Team-oriented zero defect focus group
Christiansen-Weber	Up-sized multi-state neural-net	Upgradable 3rd generation definition
Hand, Herman and O'Kon	Progressive assymetric model	Operative demand-driven benchmark
Casper, Franecki and Rutherford	Grass-roots 5th generation policy	Reactive heuristic neural-net
Breitenberg, Quitzon and Labadie	Synergized multimedia architecture	Phased responsive emulation
Balistreri and Sons	Persistent empowering synergy	Centralized fresh-thinking instruction set
Nader, Hayes and Predovic	Enterprise-wide needs-based hub	Synergized system-worthy open architecture
Sawayn, Feil and Lockman	Pre-emptive web-enabled conglomeration	Adaptive maximized alliance
Cartwright Group	Balanced maximized policy	Stand-alone bi-directional protocol
Luettgen-Hackett	Organic coherent archive	Team-oriented uniform neural-net
Adams, Frami and Marquardt	Grass-roots scalable implementation	Versatile multi-state artificial intelligence
Langworth-Kuhn	Team-oriented encompassing benchmark	Automated eco-centric database
Huel LLC	Quality-focused high-level alliance	Optimized zero administration strategy
Swaniawski, Gibson and Hayes	Total radical synergy	Extended next generation focus group
McLaughlin, Macejkovic and Rempel	Synergistic background access	Versatile exuding emulation
Stiedemann-Wolff	Quality-focused bottom-line projection	Streamlined systematic workforce
Kuvalis-Cartwright	Extended local secured line	Synchronised regional archive
Borer, Sawayn and Welch	Configurable modular analyzer	Switchable assymetric internet solution
Bartell Inc	Diverse mission-critical architecture	Stand-alone exuding moderator
Little Group	Assimilated 6th generation pricing structure	Up-sized national website
Buckridge LLC	Synergized bifurcated process improvement	Triple-buffered even-keeled open system
Mohr-Wyman	Re-engineered clear-thinking benchmark	Integrated uniform solution
Simonis Group	Public-key bottom-line portal	Fundamental local concept
Lubowitz-Carroll	Object-based bandwidth-monitored concept	Innovative uniform help-desk
Torphy-Heller	Versatile contextually-based encryption	Advanced system-worthy installation
Bartoletti, O'Conner and Homenick	Multi-tiered maximized complexity	Future-proofed motivating instruction set
Kozey Inc	Assimilated mobile process improvement	Expanded cohesive open architecture
Harvey and Sons	Diverse eco-centric knowledge base	Ergonomic demand-driven instruction set
Cremin and Sons	Reduced solution-oriented knowledge base	Digitized interactive parallelism
Schmeler-Bartoletti	Decentralized bi-directional ability	Cloned fault-tolerant info-mediaries
Heathcote-Spinka	Total hybrid data-warehouse	Business-focused 6th generation customer loyalty
Marks Group	Reactive maximized matrices	Upgradable responsive capacity
Gislason, Tromp and Hessel	Open-source human-resource projection	Multi-tiered mobile moderator
Gerhold and Sons	Public-key leading edge toolset	Seamless demand-driven matrices
Schmitt, Bogisich and Morar	Implemented next generation synergy	Progressive empowering instruction set
Kirlin-Hettinger	Organized executive info-mediaries	Future-proofed homogeneous capacity
Leuschke Inc	Grass-roots real-time middleware	Robust eco-centric support
Tillman-Jacobs	Integrated bifurcated standardization	Persistent user-facing infrastructure
Ortiz Inc	Front-line upward-trending definition	Organized directional data-warehouse
Ruecker, Mertz and Harris	Decentralized context-sensitive open system	Expanded fresh-thinking complexity
Nicolas Inc	Fully-configurable national extranet	Balanced non-volatile initiative
Maggio-Eichmann	Polarised encompassing artificial intelligence	Synergized disintermediate project
Crooks-Block	Phased bottom-line Graphic Interface	Synergistic holistic interface
Hilll-Bernhard	Managed analyzing analyzer	Expanded logistical task-force
Johns and Sons	Expanded systemic functionalities	Monitored bi-directional capacity
Muller and Sons	Open-source local info-mediaries	Implemented heuristic frame
Wiza, Heathcote and Nolan	Open-source regional migration	Up-sized asynchronous product
Prosacco, Bruen and Mayer	Advanced logistical solution	Integrated zero tolerance leverage
Stokes Inc	Expanded actuating middleware	Focused 24 hour infrastructure
Treutel-McGlynn	Right-sized discrete process improvement	Fully-configurable fresh-thinking orchestration
Rolfson, Fritsch and Wisozk	Face to face incremental moderator	Versatile executive benchmark
Ritchie, Ferry and Thompson	Automated global throughput	Multi-tiered analyzing policy
Gerhold-Hyatt	Diverse national circuit	Persevering non-volatile superstructure
Schneider-Walsh	Enterprise-wide neutral algorithm	Cross-group disintermediate info-mediaries
Hintz, Ziemann and Kuphal	Business-focused contextually-based neural-net	Persistent intangible ability
Quigley and Sons	Profit-focused real-time conglomeration	Profit-focused actuating policy
Boyer Inc	Total non-volatile software	Balanced homogeneous artificial intelligence
Treutel, Altenwerth and Boehm	Monitored actuating policy	Cross-group 24 hour emulation
Orn, Strosin and Anderson	Assimilated client-server instruction set	User-centric multi-state ability
Lowe and Sons	Synergistic value-added superstructure	Synergized discrete product
Satterfield LLC	Virtual bifurcated middleware	De-engineered logistical throughput
Bode Inc	Centralized web-enabled initiative	Configurable upward-trending archive
Schuster-Ratke	Reactive non-volatile benchmark	Team-oriented executive data-warehouse
Tromp-Luettgen	Visionary content-based implementation	Open-architected holistic model
O'Conner Inc	Implemented value-added function	Down-sized incremental alliance
O'Hara, Waelchi and Berge	Future-proofed 3rd generation analyzer	De-engineered cohesive time-frame
West Inc	Profound zero defect matrices	Ergonomic intermediate benchmark
Ebert-McClure	Persevering assymetric approach	Synergized transitional hierarchy
Pouros LLC	Switchable needs-based utilisation	Innovative background forecast
Hermiston Group	Ameliorated full-range process improvement	User-friendly system-worthy functionalities
Wintheiser-Schuster	Multi-tiered scalable product	Down-sized modular hardware
Jaskolski and Sons	Secured regional Graphic Interface	Extended secondary system engine
Durgan Group	Ameliorated zero tolerance access	Fundamental systemic firmware
Larkin, Gulgowski and Bins	Polarised cohesive toolset	Visionary composite service-desk
O'Reilly LLC	Pre-emptive impactful strategy	Open-architected disintermediate service-desk
Hoeger, Windler and Spencer	Horizontal secondary analyzer	Customer-focused clear-thinking implementation
Baumbach-Kessler	Switchable foreground analyzer	Profound didactic software
Tillman, Boyle and Lind	Enhanced 4th generation portal	Mandatory assymetric toolset
Schimmel, Goyette and Conroy	Focused methodical solution	Total impactful artificial intelligence
Koch LLC	Configurable explicit utilisation	Persistent even-keeled extranet
Larson-Corwin	Profit-focused responsive focus group	Realigned mission-critical access
Kunze Inc	Distributed asynchronous function	Business-focused heuristic artificial intelligence
Powlowski, Lockman and Dietrich	Balanced 24 hour complexity	Digitized optimizing adapter
Streich, Rodriguez and Jast	Cross-platform dynamic conglomeration	User-friendly bandwidth-monitored collaboration
Gusikowski Inc	Multi-lateral maximized moderator	Networked solution-oriented algorithm
Swaniawski Group	Pre-emptive foreground info-mediaries	Re-contextualized bottom-line budgetary management
Bogisich Group	Total bottom-line moderator	Stand-alone multi-state initiative
Tromp, Durgan and Beatty	Inverse bifurcated matrices	Ergonomic reciprocal local area network
Aufderhar-Hegmann	Multi-lateral reciprocal support	Monitored discrete challenge
Mohr-Bartell	Assimilated impactful internet solution	User-friendly asynchronous intranet
Buckridge, Dicki and Wisoky	User-friendly tangible task-force	Intuitive 5th generation conglomeration
Bradtke, Mitchell and Smitham	Configurable scalable application	Integrated 6th generation complexity
Kling-Brakus	User-centric holistic knowledge base	Open-architected empowering matrix
Mertz LLC	Vision-oriented client-driven superstructure	Synergistic disintermediate strategy
Kertzmann LLC	Self-enabling fault-tolerant encoding	Diverse bi-directional emulation
Bernhard Group	Decentralized encompassing conglomeration	Switchable needs-based moderator
Waelchi-Little	Customizable object-oriented monitoring	Down-sized non-volatile focus group
Stoltenberg-Huels	Face to face clear-thinking concept	Networked systematic alliance
Hoppe-Ruecker	Expanded impactful archive	Horizontal upward-trending productivity
Homenick, Hahn and Bashirian	Seamless discrete installation	Fully-configurable responsive budgetary management
Kunze and Sons	Decentralized asynchronous attitude	Organic systematic groupware
Bradtke-Fadel	Right-sized heuristic strategy	Enhanced actuating algorithm
Murazik LLC	Seamless local leverage	Cloned exuding initiative
Hyatt, Kshlerin and Herzog	Robust optimal initiative	De-engineered explicit info-mediaries
Ziemann, Hahn and Johns	Networked 3rd generation artificial intelligence	Secured encompassing capability
Carter Inc	Streamlined composite superstructure	Seamless homogeneous protocol
Wintheiser, Conn and Swift	Exclusive background solution	Synergistic bifurcated service-desk
Prosacco, Dickens and Gutkowski	Cross-platform eco-centric open system	Assimilated background budgetary management
Dare, Steuber and Conroy	Diverse coherent throughput	Organic logistical Graphic Interface
Anderson-Legros	Streamlined hybrid architecture	Multi-tiered global protocol
O'Reilly, Hagenes and Buckridge	Realigned intangible paradigm	Centralized bifurcated strategy
Champlin LLC	Down-sized empowering framework	Multi-layered 6th generation initiative
Kertzmann-Hirthe	Total modular definition	Configurable clear-thinking projection
Kautzer Group	Monitored stable capability	Vision-oriented intangible customer loyalty
Wolff, Grant and Medhurst	Stand-alone full-range challenge	Secured client-server pricing structure
Cummerata-Hartmann	Compatible zero administration model	Self-enabling human-resource instruction set
Hamill-Schulist	Seamless web-enabled migration	Integrated fault-tolerant infrastructure
Olson-Hickle	Optional incremental time-frame	Switchable encompassing flexibility
Parisian LLC	Upgradable object-oriented benchmark	Expanded fault-tolerant data-warehouse
Lesch-Brown	Up-sized client-server middleware	Focused tertiary architecture
Rau, Swaniawski and Macejkovic	Multi-tiered national intranet	Re-engineered analyzing definition
Watsica-Jewess	Proactive zero administration software	Phased directional moderator
Torphy Group	Innovative 24/7 budgetary management	Open-source assymetric firmware
Murphy LLC	Fully-configurable multi-tasking artificial intelligence	Team-oriented asynchronous artificial intelligence
Goldner-Murphy	Seamless heuristic initiative	Synergistic solution-oriented throughput
D'Amore, Bailey and Grant	Monitored local function	Public-key bi-directional matrices
Raynor, Kemmer and Schinner	Progressive 3rd generation parallelism	Open-source 6th generation standardization
Hegmann-Gerhold	Customizable fresh-thinking customer loyalty	Horizontal actuating definition
Harber-Oberbrunner	Fundamental static Graphical User Interface	Open-architected maximized forecast
Rosenbaum-Dare	Centralized radical artificial intelligence	Fully-configurable secondary projection
Johns, Fisher and Schuppe	Quality-focused solution-oriented infrastructure	Self-enabling object-oriented array
Hodkiewicz-Windler	Business-focused exuding challenge	User-friendly modular orchestration
Witting-King	Synchronised multi-tasking parallelism	Fully-configurable next generation encryption
Russel-Bergstrom	Realigned eco-centric database	Extended motivating pricing structure
Runolfsdottir-Bayer	Focused zero defect local area network	Synergistic multi-state knowledge user
Oberbrunner, Jacobson and Bode	Re-engineered intermediate system engine	Fundamental tangible collaboration
Willms Inc	Public-key 4th generation software	Seamless methodical throughput
Pouros and Sons	Adaptive multi-state forecast	Optional even-keeled moderator
Murphy Inc	Multi-tiered dynamic pricing structure	Pre-emptive mission-critical complexity
Moen and Sons	Business-focused client-server algorithm	Triple-buffered zero tolerance help-desk
Durgan and Sons	Reactive value-added project	Innovative 24/7 project
Corwin LLC	Customizable multi-state model	Optimized global structure
Dooley, Jacobson and Eichmann	Balanced tangible policy	Vision-oriented asynchronous customer loyalty
Schmitt and Sons	Right-sized 24 hour ability	Self-enabling neutral infrastructure
Feeney-Schmeler	Down-sized solution-oriented superstructure	Customizable dynamic ability
McClure-Crist	Networked 5th generation structure	Fundamental cohesive data-warehouse
Feest-Durgan	Advanced homogeneous capability	Robust system-worthy portal
Lowe, Tillman and Marks	Synergistic foreground methodology	Re-engineered secondary encoding
Douglas-Gerhold	Robust bottom-line moderator	Synchronised reciprocal moderator
Fisher and Sons	Open-source local portal	Centralized exuding customer loyalty
Kohler-Ziemann	Managed methodical access	Object-based neutral circuit
Lang-Grimes	Cross-group encompassing initiative	Down-sized intangible core
Parisian-Rippin	Open-architected human-resource definition	Diverse web-enabled system engine
Funk-Hills	Upgradable global budgetary management	Face to face 4th generation challenge
Gibson Group	Compatible radical flexibility	Seamless analyzing intranet
Ortiz, Zulauf and Schinner	Down-sized heuristic flexibility	Down-sized impactful strategy
Koelpin Group	Profound local neural-net	Function-based zero defect workforce
Bashirian, Ledner and Prosacco	Cross-group national contingency	Assimilated transitional groupware
Fisher, Boyle and Christiansen	Compatible composite capability	Customizable assymetric forecast
Goodwin, Lubowitz and Ankunding	Extended explicit workforce	Devolved secondary function
Veum Inc	Inverse user-facing orchestration	Extended optimal policy
Jacobi LLC	Pre-emptive empowering database	Diverse optimizing local area network
Pagac and Sons	Automated discrete orchestration	Cloned radical info-mediaries
Bode-Streich	Multi-channelled web-enabled workforce	Profit-focused intangible pricing structure
Rutherford-Herman	Business-focused 24 hour paradigm	Reverse-engineered optimizing success
Kshlerin-Harris	Self-enabling didactic data-warehouse	Persevering analyzing application
Dooley-Bergstrom	Configurable real-time data-warehouse	Multi-tiered discrete service-desk
Bailey-Berge	Face to face even-keeled functionalities	Expanded systematic architecture
Leannon Group	Multi-layered exuding architecture	Streamlined zero administration algorithm
Murray, Sawayn and Langworth	Optional next generation attitude	Reverse-engineered scalable challenge
Dicki, Herman and Hahn	Balanced disintermediate success	Public-key systematic focus group
Gibson, Greenfelder and Schamberger	Triple-buffered modular groupware	Persevering foreground alliance
Lemke-Wiegand	Implemented homogeneous moratorium	Managed multi-state throughput
Stamm and Sons	Multi-tiered optimizing groupware	Implemented bi-directional artificial intelligence
Pacocha-Ratke	Up-sized zero defect secured line	Operative client-server concept
Welch Inc	Reduced didactic task-force	Expanded 24 hour approach
Koelpin, Smith and Bins	Intuitive bi-directional time-frame	Managed well-modulated installation
Kuhic Group	Vision-oriented 6th generation toolset	Enterprise-wide needs-based capability
Yost-Klocko	Organized empowering Graphical User Interface	Multi-layered local service-desk
Stokes, Reilly and Reilly	Switchable regional task-force	Synergized explicit protocol
Corwin-Jast	Multi-layered scalable utilisation	Proactive methodical open architecture
Boyle-Dibbert	Team-oriented neutral customer loyalty	Right-sized responsive task-force
Corkery-Shanahan	Front-line intangible moderator	Expanded logistical Graphic Interface
Donnelly Inc	Exclusive bi-directional firmware	Decentralized multi-state system engine
Ullrich-Klocko	Configurable holistic benchmark	Secured intangible ability
O'Keefe LLC	Organic optimal hub	Quality-focused bi-directional capacity
Stehr-Stanton	Business-focused interactive hub	Virtual full-range initiative
Haag, Waelchi and Satterfield	Configurable interactive focus group	Quality-focused object-oriented encryption
Nicolas Inc	Automated content-based budgetary management	Reactive background protocol
Nader, Pouros and Brakus	Object-based high-level forecast	Ameliorated disintermediate contingency
Miller, Schultz and Murphy	Persevering asynchronous projection	Adaptive mission-critical service-desk
Rolfson, Collier and West	Re-engineered human-resource synergy	Cross-platform holistic toolset
Miller, D'Amore and Bashirian	Self-enabling grid-enabled system engine	Diverse homogeneous infrastructure
Graham and Sons	Multi-tiered systematic frame	Progressive next generation policy
Von-Bauch	Switchable 24 hour help-desk	Enterprise-wide fault-tolerant neural-net
Kutch, Pagac and Casper	Cloned directional parallelism	Synergistic system-worthy access
Gusikowski, Gibson and Kling	Open-architected uniform access	Proactive discrete framework
Mohr and Sons	Down-sized intermediate utilisation	Synergistic zero administration parallelism
Hand, Wiza and Abernathy	Innovative solution-oriented structure	Integrated bi-directional concept
Baumbach-VonRueden	Versatile 6th generation architecture	Upgradable executive intranet
Trantow, Braun and Pfannerstill	Profound modular methodology	User-friendly national strategy
Lang, Emmerich and Wunsch	Public-key 4th generation budgetary management	Proactive intangible matrix
Dibbert and Sons	Re-contextualized directional hardware	Monitored homogeneous intranet
Wisozk-Hettinger	Re-contextualized encompassing task-force	Mandatory web-enabled software
Crist, Kessler and Howe	Customer-focused fault-tolerant conglomeration	Expanded zero tolerance service-desk
Mueller, Bins and Kihn	Cross-group radical application	Profound client-driven matrices
Paucek Inc	Sharable mobile customer loyalty	Down-sized hybrid hardware
Smith LLC	Seamless non-volatile monitoring	Compatible 3rd generation collaboration
Beatty Group	Business-focused value-added Graphic Interface	Integrated 6th generation superstructure
Goodwin, Cole and Shanahan	Multi-tiered homogeneous success	Right-sized grid-enabled analyzer
Halvorson-Lockman	Front-line attitude-oriented leverage	Enterprise-wide systemic throughput
Kertzmann-Blick	Virtual maximized function	Focused analyzing circuit
Reichel, Towne and Graham	Intuitive bifurcated customer loyalty	Open-architected responsive capability
Barrows, Spencer and Cassin	Intuitive radical application	Persevering national neural-net
Kirlin Group	Centralized incremental contingency	Reduced analyzing definition
Hansen-Koch	Operative motivating hierarchy	Future-proofed content-based focus group
Halvorson and Sons	Distributed neutral encoding	Enterprise-wide background model
Fay, Sanford and Hermann	Upgradable methodical parallelism	Proactive intermediate leverage
Aufderhar Inc	Front-line fresh-thinking hub	Configurable attitude-oriented leverage
Rutherford-Balistreri	Reverse-engineered systemic attitude	Switchable heuristic hardware
Conn LLC	Re-engineered incremental monitoring	Re-engineered optimizing moderator
Rodriguez-Schneider	Business-focused zero administration implementation	Synergistic modular attitude
Emmerich-Rogahn	Intuitive background attitude	Secured actuating utilisation
Beier-Wilkinson	Profound 24 hour monitoring	Phased 5th generation function
Turcotte-Lubowitz	Digitized coherent hub	Function-based modular superstructure
Kuhic, Bahringer and Bauch	Switchable zero tolerance task-force	Exclusive logistical ability
Howe-VonRueden	Profound fault-tolerant support	Operative asynchronous monitoring
Ondricka LLC	Diverse multi-state hub	Synergistic multi-tasking success
Graham-Hahn	Proactive optimal paradigm	Networked radical hub
Cole, Metz and Barrows	De-engineered user-facing collaboration	Persevering multi-state algorithm
Hauck-Gaylord	Centralized impactful groupware	Phased analyzing budgetary management
Gaylord, Corwin and Ullrich	Configurable full-range functionalities	Down-sized mobile framework
Morar LLC	Object-based tangible matrices	Function-based fresh-thinking application
Reinger, Hettinger and Marquardt	Optimized homogeneous concept	Phased intermediate emulation
Kris, Ebert and Towne	Synchronised optimizing moratorium	Proactive optimal ability
Durgan LLC	Integrated tertiary process improvement	Optional system-worthy task-force
Volkman, Baumbach and Fisher	Programmable background portal	Self-enabling modular local area network
Kirlin and Sons	Reactive intermediate flexibility	Secured well-modulated internet solution
Littel, Rice and Sauer	De-engineered directional core	Cross-group asynchronous throughput
Jacobson Inc	Networked reciprocal contingency	Multi-channelled system-worthy matrices
Hahn Group	Public-key analyzing orchestration	Horizontal grid-enabled artificial intelligence
Senger-Ryan	Digitized executive interface	Monitored coherent workforce
Schumm-Heathcote	Integrated global portal	Visionary tangible analyzer
Rowe and Sons	Enterprise-wide asynchronous service-desk	Right-sized multi-tasking methodology
Huels-Waelchi	User-centric web-enabled infrastructure	Phased full-range data-warehouse
Senger-Emard	Assimilated grid-enabled application	Assimilated multi-tasking knowledge user
Rowe, O'Kon and Nienow	Public-key eco-centric website	Optional system-worthy alliance
Adams-Johnston	Customizable multi-tasking hub	Intuitive multi-state success
Kihn Inc	Profound 4th generation product	Phased bi-directional orchestration
Herzog, Glover and Rodriguez	Inverse directional conglomeration	Cross-group optimal application
Murazik-VonRueden	Mandatory uniform matrix	Secured tertiary time-frame
Champlin Inc	Team-oriented intermediate firmware	Triple-buffered optimal ability
Hayes-Maggio	Sharable motivating internet solution	Synchronised incremental pricing structure
Runolfsson, Hickle and Effertz	Down-sized local circuit	Monitored fault-tolerant toolset
Feeney-Cormier	Compatible tertiary hierarchy	Decentralized incremental circuit
Koelpin Group	Ameliorated heuristic array	Synchronised needs-based pricing structure
Powlowski-Gislason	Open-source bandwidth-monitored core	Fully-configurable didactic complexity
Lang-Ruecker	Integrated hybrid encryption	Fully-configurable modular structure
Mosciski, Sporer and Bahringer	Universal coherent process improvement	Triple-buffered attitude-oriented Graphical User Interface
Ondricka-Crona	Digitized hybrid leverage	Total local monitoring
Rohan-Nitzsche	Reactive analyzing intranet	Innovative demand-driven methodology
Donnelly-Reichel	Progressive contextually-based definition	Digitized demand-driven groupware
Kuvalis and Sons	Self-enabling assymetric intranet	User-friendly even-keeled paradigm
O'Kon Inc	Self-enabling well-modulated functionalities	Sharable upward-trending moratorium
Champlin Group	Up-sized radical moderator	Inverse incremental ability
Labadie Inc	Phased mobile structure	Grass-roots full-range database
Goodwin LLC	Public-key national methodology	Seamless methodical application
Crist and Sons	Expanded bi-directional functionalities	Upgradable optimal migration
Hagenes LLC	Seamless zero defect archive	Profit-focused bi-directional task-force
Hintz Inc	Adaptive high-level Graphical User Interface	Seamless multi-state implementation
Lebsack and Sons	Customizable empowering customer loyalty	Reactive empowering complexity
Fisher-Mills	Distributed neutral portal	Triple-buffered incremental open system
Beier-Kirlin	Down-sized holistic middleware	Centralized stable matrix
Kutch-Lemke	Face to face uniform ability	Universal scalable support
Schamberger and Sons	User-friendly fault-tolerant website	Mandatory cohesive superstructure
Cronin and Sons	Innovative secondary local area network	Up-sized systematic secured line
Funk Group	Programmable object-oriented moratorium	Universal asynchronous solution
Ledner Group	Up-sized high-level knowledge user	Vision-oriented leading edge hardware
Bogisich-Jones	Programmable content-based knowledge base	Team-oriented leading edge flexibility
Little and Sons	Sharable methodical initiative	Realigned solution-oriented circuit
Dibbert Group	Profit-focused modular access	Configurable content-based synergy
Dach Inc	Re-contextualized non-volatile strategy	Front-line 6th generation collaboration
Torp, Lakin and Adams	Decentralized modular success	Pre-emptive web-enabled leverage
Hane LLC	Re-engineered well-modulated approach	De-engineered user-facing application
Grant, Beahan and McClure	Enhanced 24/7 ability	Virtual uniform frame
Bode-Homenick	Adaptive neutral moratorium	Extended homogeneous implementation
Dickinson, Murazik and Goldner	Synergized multimedia definition	Implemented 3rd generation leverage
Abbott, Schinner and Wisoky	Triple-buffered fault-tolerant approach	Monitored empowering toolset
Bednar LLC	Horizontal human-resource capacity	Future-proofed coherent ability
Beahan Inc	Synchronised explicit approach	Innovative global challenge
Kunze-Crona	Digitized multi-tasking definition	Focused regional neural-net
Pacocha-Harris	Automated non-volatile projection	Optimized zero tolerance initiative
Abshire and Sons	Customizable object-oriented paradigm	Seamless upward-trending firmware
Bogan, Bins and Davis	Cloned system-worthy moderator	Enhanced client-server flexibility
Heathcote and Sons	Networked 4th generation methodology	Synergistic executive pricing structure
Russel, McCullough and Pacocha	Open-source real-time internet solution	Digitized radical protocol
Kuhn-Feeney	Optional homogeneous workforce	Organic assymetric hub
Kihn, Feeney and Cormier	Adaptive dynamic neural-net	Focused 5th generation hierarchy
Gleason and Sons	Face to face upward-trending website	Mandatory 24 hour utilisation
Kirlin, DuBuque and Schaden	Versatile high-level methodology	Expanded contextually-based Graphic Interface
Conroy LLC	Up-sized solution-oriented matrix	Operative holistic neural-net
Hills Group	Universal disintermediate access	Configurable dedicated middleware
Kemmer-Sawayn	Mandatory modular collaboration	Organized tangible structure
Monahan Group	Streamlined exuding projection	Polarised real-time parallelism
Tromp LLC	Centralized tertiary synergy	Reduced 3rd generation data-warehouse
Friesen LLC	Function-based tangible instruction set	Organized 6th generation framework
Swaniawski, Klein and Bailey	Reduced clear-thinking hub	Optimized eco-centric collaboration
Cartwright-Lind	Synchronised executive internet solution	Devolved 5th generation info-mediaries
Block Inc	Synergistic eco-centric utilisation	Down-sized background structure
Carter-Gottlieb	Inverse asynchronous implementation	Upgradable user-facing circuit
Bailey Inc	Down-sized optimal ability	Extended 24 hour Graphic Interface
Pfannerstill Group	Robust context-sensitive adapter	Organized multimedia neural-net
VonRueden, Champlin and Feil	Intuitive exuding strategy	Automated 24/7 database
Kiehn LLC	Seamless upward-trending algorithm	Self-enabling user-facing instruction set
Ullrich LLC	Distributed multi-state array	Expanded global utilisation
Stoltenberg-Bruen	Function-based 24 hour utilisation	Reverse-engineered clear-thinking instruction set
O'Conner-Kassulke	Realigned systemic hub	Triple-buffered 24/7 algorithm
Brakus-Buckridge	Triple-buffered encompassing conglomeration	User-friendly next generation system engine
Rippin and Sons	Digitized encompassing ability	Object-based analyzing initiative
Hills, Kiehn and Dietrich	Synergized assymetric standardization	Profound discrete functionalities
Zieme Inc	Quality-focused 3rd generation monitoring	Grass-roots reciprocal architecture
Braun Group	Synergistic background encoding	Configurable client-server internet solution
Huels Group	Organic 5th generation initiative	Upgradable composite archive
Hessel, Hermann and Lynch	Visionary zero administration parallelism	Virtual holistic parallelism
Moore LLC	Automated contextually-based productivity	Balanced web-enabled infrastructure
Weber-Torphy	Open-architected client-server parallelism	Profit-focused attitude-oriented portal
Satterfield-Oberbrunner	Switchable cohesive success	Profound user-facing methodology
Miller, White and Hickle	Down-sized homogeneous Graphic Interface	Implemented foreground moratorium
Kilback Inc	Down-sized stable instruction set	Monitored analyzing adapter
Stracke, Spinka and Brown	Multi-channelled 24 hour hardware	Configurable 3rd generation installation
Fritsch and Sons	Streamlined multi-tasking software	Innovative incremental product
Sporer-Barton	Exclusive multi-state framework	Balanced leading edge function
Muller-Rodriguez	Operative encompassing paradigm	Open-source 24/7 forecast
Bechtelar-Hintz	Monitored high-level moderator	Realigned incremental access
Buckridge-Barrows	Digitized attitude-oriented hierarchy	Reverse-engineered high-level complexity
Kiehn Group	Multi-layered zero administration help-desk	Expanded cohesive ability
Rice and Sons	Mandatory human-resource forecast	User-centric reciprocal parallelism
Lemke, Borer and Reinger	Ameliorated stable synergy	Front-line grid-enabled alliance
Beer and Sons	Synergistic 6th generation forecast	Business-focused intangible local area network
Blanda, Tromp and Herzog	Total human-resource open architecture	Centralized context-sensitive protocol
Jakubowski-Marquardt	Expanded zero defect flexibility	Optimized modular complexity
Denesik and Sons	Public-key fresh-thinking matrices	Decentralized value-added emulation
Shields, Lowe and Lind	Reactive web-enabled analyzer	Programmable zero tolerance synergy
Stamm, Gusikowski and Pfeffer	Organic web-enabled Graphical User Interface	Diverse optimizing implementation
Koelpin, Boyer and Murphy	Intuitive fault-tolerant strategy	Customizable eco-centric success
Donnelly-Volkman	Integrated motivating project	Reverse-engineered bottom-line concept
Ratke-Pfeffer	Adaptive executive customer loyalty	Digitized global workforce
Harber, Koepp and Borer	Customer-focused multi-state frame	Assimilated secondary encoding
Torp, Skiles and Murazik	Business-focused 24 hour circuit	Secured contextually-based standardization
Wiza-Pollich	Networked user-facing time-frame	Customer-focused client-server solution
Lang, Herzog and Feeney	Exclusive neutral superstructure	Multi-layered context-sensitive challenge
Beatty Inc	Profit-focused real-time adapter	Expanded clear-thinking orchestration
Mohr, Torp and Douglas	Adaptive needs-based contingency	Robust national database
Orn, Corwin and Kutch	Multi-tiered value-added concept	Ameliorated mobile open system
Batz-Rogahn	Vision-oriented analyzing emulation	Upgradable dynamic data-warehouse
Lesch-Haley	Expanded responsive alliance	Compatible cohesive productivity
Pollich-Stokes	Multi-channelled global analyzer	Customer-focused secondary adapter
Okuneva LLC	Synchronised maximized hardware	Public-key encompassing local area network
Doyle-Pouros	Compatible incremental utilisation	Robust radical approach
Mertz, Welch and Abbott	Synergistic demand-driven superstructure	Sharable national pricing structure
Reichert Group	Inverse 24/7 toolset	Triple-buffered 4th generation product
Weissnat-Stroman	Multi-channelled mission-critical installation	Face to face web-enabled conglomeration
Douglas Group	Innovative cohesive system engine	Open-source grid-enabled moratorium
Welch Group	Polarised 6th generation process improvement	Horizontal motivating approach
Denesik, Treutel and Haag	Integrated foreground productivity	Down-sized system-worthy hub
Johnston-Wyman	Compatible needs-based implementation	Customer-focused hybrid hardware
Schuppe Group	Profound 24 hour Graphical User Interface	Advanced 4th generation focus group
Dickens, Hudson and Considine	Sharable transitional core	Centralized background protocol
Ullrich, McGlynn and Renner	Organized clear-thinking workforce	Triple-buffered transitional moratorium
Reichel and Sons	Mandatory dedicated archive	Centralized user-facing archive
Rippin Group	Seamless well-modulated hub	Assimilated optimal budgetary management
Jerde-Ward	Stand-alone modular moderator	Open-architected 24 hour task-force
O'Connell-Hessel	Function-based national Graphical User Interface	Secured object-oriented complexity
Stoltenberg-Botsford	Ameliorated modular Graphical User Interface	Ergonomic executive neural-net
McLaughlin, Mann and Conn	Grass-roots fresh-thinking hub	Virtual solution-oriented help-desk
Lesch and Sons	Open-source analyzing array	Public-key 24 hour instruction set
Kerluke-Koss	Cloned user-facing emulation	Programmable modular Graphical User Interface
Glover and Sons	Focused well-modulated firmware	Horizontal foreground installation
Osinski Inc	Secured coherent superstructure	Distributed actuating adapter
Yost, Cruickshank and Ankunding	Function-based foreground challenge	Streamlined motivating parallelism
Parker, Huels and Mills	Horizontal systemic service-desk	Cloned grid-enabled implementation
Rice, Murray and Hilll	Synergistic upward-trending methodology	De-engineered systemic contingency
Will LLC	Compatible encompassing synergy	Extended interactive portal
Breitenberg, Harber and Schultz	Digitized asynchronous concept	Decentralized bandwidth-monitored synergy
Nolan-Larkin	Open-source context-sensitive product	Reverse-engineered 24 hour hierarchy
Kuhlman and Sons	Fully-configurable responsive array	Triple-buffered object-oriented core
Marvin, Toy and Wolff	Re-contextualized impactful projection	Advanced multi-state protocol
Block LLC	Streamlined uniform adapter	Open-architected user-facing encryption
Fritsch-Gusikowski	Multi-tiered exuding challenge	Centralized optimal Graphic Interface
Mohr and Sons	Digitized tertiary core	Monitored content-based software
Wolf-Abshire	Grass-roots radical implementation	Profit-focused incremental conglomeration
Maggio, Parker and Schaden	Profound background emulation	Sharable 4th generation capacity
Sauer-Padberg	Streamlined tertiary challenge	Universal disintermediate array
Yost-Ruecker	Diverse transitional throughput	Total intangible open system
Kilback-Fay	Upgradable directional structure	Distributed leading edge structure
Jewess, Kautzer and Bogisich	Open-source executive superstructure	Monitored leading edge contingency
Hane LLC	Networked even-keeled infrastructure	Balanced methodical firmware
Mohr-Reichert	Customer-focused asynchronous flexibility	Front-line analyzing installation
Dietrich-Durgan	Networked user-facing Graphical User Interface	Front-line solution-oriented hardware
Mertz, Koepp and Bernier	Proactive discrete success	Reverse-engineered optimizing architecture
Donnelly Group	Inverse holistic installation	Open-architected 3rd generation algorithm
Waters, Waters and Ward	Down-sized leading edge core	Universal uniform structure
Hoppe and Sons	Universal mission-critical portal	Visionary static time-frame
Willms Group	Triple-buffered local data-warehouse	Fully-configurable composite synergy
Harris, Waters and Wilderman	Up-sized object-oriented benchmark	Organic well-modulated challenge
Rice-Pollich	Assimilated impactful collaboration	Switchable coherent functionalities
Lockman, Williamson and Osinski	Focused stable functionalities	Multi-lateral zero administration archive
Quitzon Group	Phased non-volatile solution	Organic attitude-oriented methodology
Hartmann-Grady	Reactive multi-state middleware	Progressive logistical productivity
Bahringer, Schowalter and Simonis	Robust holistic collaboration	Polarised explicit system engine
Bayer, Windler and Hilll	Phased 6th generation model	Programmable intermediate superstructure
Dare and Sons	Diverse impactful projection	Intuitive impactful internet solution
Considine, Simonis and Cruickshank	Multi-tiered uniform internet solution	Universal bifurcated time-frame
Koepp Inc	Streamlined multi-tasking database	Self-enabling multi-state ability
Marvin-Bergnaum	Synergistic client-driven product	Versatile high-level initiative
Gislason-Dickinson	Grass-roots 24/7 groupware	Right-sized web-enabled function
Olson, Zboncak and Marquardt	Face to face explicit approach	Synergistic cohesive data-warehouse
Bechtelar, Yost and Koss	Implemented discrete complexity	Reactive tangible emulation
Tremblay Group	Multi-tiered directional paradigm	Organic logistical initiative
Bechtelar, Conroy and Schuppe	Synergized uniform customer loyalty	Phased methodical artificial intelligence
Abbott, Mohr and O'Conner	Adaptive content-based time-frame	Ergonomic mobile analyzer
Kihn Group	Centralized holistic moderator	Self-enabling national frame
Bartell, Price and Casper	Multi-layered regional architecture	Face to face demand-driven leverage
O'Keefe-Luettgen	User-friendly scalable interface	Optimized eco-centric moratorium
Jacobs and Sons	Automated dedicated open system	Total high-level installation
Kuvalis-Kuphal	Vision-oriented explicit structure	Versatile global help-desk
Wolff Inc	Cross-group empowering throughput	Customer-focused mobile migration
Kris, Robel and Towne	Right-sized executive knowledge base	Networked solution-oriented concept
Raynor, Bahringer and Gaylord	Streamlined value-added throughput	Quality-focused heuristic ability
Sauer-Lubowitz	Intuitive 6th generation approach	Configurable multi-tasking infrastructure
Stark-Gerlach	Configurable 6th generation matrix	Visionary multi-state flexibility
O'Hara-Welch	Customer-focused dedicated superstructure	Synergistic bi-directional help-desk
Windler, Spinka and Sipes	Function-based composite interface	Optional systematic conglomeration
Rau-Gerlach	Networked client-driven infrastructure	Networked web-enabled knowledge user
Boyle-Lebsack	Decentralized assymetric pricing structure	Compatible multi-tasking project
Reichel-Satterfield	Secured maximized local area network	Virtual modular framework
O'Hara-Weimann	Cloned didactic Graphical User Interface	Compatible tertiary approach
Kunze, Reilly and Bartell	Synergized needs-based internet solution	Optional maximized knowledge base
Wunsch-Adams	User-friendly transitional policy	Expanded leading edge neural-net
Bayer Inc	Right-sized systemic customer loyalty	Realigned user-facing budgetary management
Ruecker-Kiehn	Extended full-range attitude	User-centric zero administration workforce
Roob-Aufderhar	Down-sized logistical interface	Optimized maximized function
Anderson-Baumbach	Pre-emptive tertiary time-frame	Reverse-engineered radical open architecture
Reichert, Hudson and Welch	Centralized assymetric projection	Seamless real-time strategy
Smitham, Morissette and Langosh	Focused solution-oriented software	Automated intermediate definition
Hammes Group	Synergized maximized monitoring	Synergistic impactful implementation
Bailey Group	Distributed zero tolerance extranet	Vision-oriented stable process improvement
Terry Inc	Re-contextualized holistic interface	Digitized 4th generation orchestration
McKenzie-Herman	Intuitive national open system	Multi-channelled systematic product
Yundt-Weissnat	Compatible national Graphic Interface	Grass-roots full-range model
Dach Group	Cloned high-level attitude	Diverse national local area network
Cassin, Fritsch and Murazik	Inverse object-oriented architecture	Reactive transitional capacity
Carter-Veum	Cross-group methodical pricing structure	Visionary hybrid intranet
White, Hermann and Sauer	Innovative even-keeled orchestration	Distributed secondary migration
Kreiger Inc	Fundamental scalable knowledge base	Innovative exuding policy
Smith Inc	Distributed zero administration conglomeration	Optimized incremental intranet
Hyatt Group	Profound needs-based project	Multi-lateral multimedia matrices
Turcotte, Effertz and Erdman	Triple-buffered leading edge analyzer	Virtual cohesive groupware
Champlin-Heaney	Self-enabling tertiary complexity	Enterprise-wide responsive customer loyalty
Heidenreich-Labadie	Secured client-server access	Synchronised bandwidth-monitored focus group
Ritchie and Sons	Operative homogeneous workforce	Grass-roots empowering ability
Mayert and Sons	Configurable directional flexibility	Business-focused modular help-desk
Gorczany-Gerlach	Organized encompassing hub	Seamless multi-tasking hardware
Hintz LLC	Intuitive even-keeled system engine	Exclusive multi-tasking ability
Gislason-Cummings	Configurable background analyzer	Visionary contextually-based database
Dooley, Denesik and Gulgowski	Open-source scalable monitoring	Versatile composite monitoring
Konopelski Group	Focused client-driven parallelism	Cross-platform even-keeled ability
Kris-Kris	Ameliorated regional attitude	Balanced fresh-thinking instruction set
Casper, Howe and Gutkowski	Realigned content-based standardization	Operative fault-tolerant model
Watsica Inc	Ameliorated scalable strategy	Balanced disintermediate middleware
Buckridge-Schroeder	Self-enabling human-resource neural-net	Innovative object-oriented alliance
Leuschke-Leuschke	Public-key scalable throughput	Future-proofed 3rd generation secured line
Reichert, Gleason and Dare	Future-proofed client-driven methodology	Versatile directional paradigm
Prohaska Inc	Future-proofed 5th generation infrastructure	Team-oriented incremental framework
Lebsack Group	Customizable zero tolerance architecture	Exclusive executive system engine
Hickle-Douglas	Automated context-sensitive definition	Polarised encompassing model
Ferry, Zulauf and Cole	Extended intangible neural-net	Intuitive leading edge access
Purdy, Rice and Heller	Open-source object-oriented matrix	De-engineered contextually-based process improvement
Tillman Group	De-engineered composite policy	Networked intermediate task-force
Yost and Sons	Balanced motivating secured line	Persistent even-keeled local area network
McGlynn LLC	Managed fresh-thinking hardware	Visionary attitude-oriented knowledge user
Hilll, Kunde and Klein	Devolved disintermediate Graphic Interface	De-engineered responsive hub
Kuhic and Sons	Intuitive system-worthy encoding	Persistent systematic hub
Jaskolski, Borer and Hyatt	Customer-focused methodical approach	Team-oriented full-range infrastructure
Jaskolski-DuBuque	Fundamental zero administration archive	Implemented transitional help-desk
Daniel-Ryan	Realigned client-server leverage	Phased discrete open architecture
Zieme-Veum	Compatible executive collaboration	Pre-emptive stable flexibility
Gutkowski-Funk	Multi-channelled maximized complexity	Down-sized human-resource collaboration
Ortiz-Beier	Focused full-range analyzer	Cross-group encompassing artificial intelligence
Von, Quigley and Flatley	Inverse directional hub	Persistent real-time success
Kris and Sons	Progressive disintermediate analyzer	Cloned object-oriented flexibility
Huels, Dach and Keebler	Organic human-resource paradigm	Pre-emptive 6th generation Graphic Interface
Casper-Goyette	Operative systemic benchmark	Business-focused tertiary projection
Kutch-Welch	Operative stable alliance	Cross-platform discrete service-desk
Shields, Kautzer and Bergnaum	Realigned foreground project	Inverse client-server success
Tillman, Walter and Schmitt	Ergonomic needs-based portal	Digitized next generation framework
Raynor-Schaden	Face to face upward-trending matrix	Robust system-worthy monitoring
Balistreri Group	Multi-channelled 24 hour concept	Team-oriented impactful implementation
Stamm-Rutherford	Self-enabling background portal	Reverse-engineered bottom-line installation
Cormier and Sons	Implemented stable conglomeration	Progressive coherent open system
Lowe Inc	Programmable zero defect open system	De-engineered upward-trending benchmark
King Inc	Networked analyzing functionalities	Fully-configurable tertiary groupware
Morissette-Kuhlman	Re-contextualized 24/7 collaboration	Reactive web-enabled monitoring
Hansen Group	Decentralized 3rd generation structure	Upgradable intangible algorithm
Carter-Ullrich	Seamless static firmware	Future-proofed multi-tasking Graphic Interface
Treutel, Goldner and Toy	Horizontal 3rd generation capacity	Realigned multi-tasking process improvement
Torp-Mills	Universal intermediate database	Fundamental heuristic middleware
Rice-Schumm	Right-sized maximized analyzer	Multi-channelled contextually-based focus group
Kemmer-Conroy	Public-key high-level concept	Assimilated tangible monitoring
Waters, Herzog and Greenfelder	Persistent uniform capacity	Streamlined coherent hierarchy
Grady, Emmerich and Collier	Multi-tiered empowering monitoring	Visionary radical framework
Osinski and Sons	Ergonomic grid-enabled superstructure	Reverse-engineered secondary instruction set
O'Hara, Lesch and Dibbert	Programmable foreground artificial intelligence	Function-based attitude-oriented website
Marks, McDermott and King	Virtual optimal open system	Integrated system-worthy extranet
Wilderman, Jakubowski and Ledner	Public-key eco-centric contingency	Universal bandwidth-monitored attitude
Gaylord, Ankunding and Kertzmann	Function-based bifurcated benchmark	Proactive fresh-thinking website
Toy Inc	Persevering empowering time-frame	Digitized global installation
Schinner Group	Horizontal grid-enabled open system	Networked heuristic moderator
Rippin, Christiansen and Wolff	Exclusive motivating model	Mandatory hybrid hardware
Klocko-Koelpin	Innovative interactive capability	Multi-layered intangible implementation
Orn-Senger	Ergonomic even-keeled parallelism	Synchronised context-sensitive service-desk
Purdy Group	Horizontal motivating extranet	Assimilated clear-thinking artificial intelligence
Cormier-Jast	Implemented encompassing instruction set	Organic background core
Harris, Upton and Ruecker	Object-based 6th generation alliance	Profound secondary capacity
Wunsch Group	Diverse disintermediate matrix	Configurable methodical knowledge base
Friesen Group	Self-enabling well-modulated extranet	Visionary user-facing core
Gutkowski Inc	Configurable executive knowledge base	Quality-focused mission-critical help-desk
O'Reilly Group	Face to face needs-based forecast	Streamlined leading edge data-warehouse
McDermott-Strosin	Implemented local protocol	Re-engineered modular analyzer
Weimann-West	Expanded secondary leverage	Cross-platform impactful application
Kirlin, Swift and Hackett	Fundamental stable process improvement	Switchable empowering installation
McClure, O'Conner and Jaskolski	Virtual systematic instruction set	Multi-layered optimal hardware
Gleason-Anderson	Multi-layered empowering leverage	Monitored reciprocal superstructure
Gusikowski-McGlynn	Open-architected multi-state policy	Enterprise-wide grid-enabled parallelism
Hilpert-Mante	Enterprise-wide assymetric challenge	Public-key 3rd generation parallelism
Johnson, Stracke and O'Keefe	Synergistic clear-thinking conglomeration	Distributed systematic approach
Farrell-Hayes	Balanced even-keeled website	Multi-layered encompassing benchmark
Reinger, Ziemann and Bauch	Digitized methodical definition	Multi-channelled 3rd generation approach
Lynch LLC	Realigned attitude-oriented standardization	Polarised needs-based analyzer
McKenzie-Mitchell	Multi-lateral next generation frame	Profound web-enabled Graphical User Interface
Murphy, Welch and Hettinger	Digitized multi-tasking internet solution	Multi-layered bandwidth-monitored functionalities
Little-Beier	Mandatory 4th generation functionalities	Quality-focused multi-state moratorium
Konopelski, Jerde and Hermann	Reduced uniform challenge	Reactive asynchronous knowledge user
Mosciski-Heller	Polarised fresh-thinking challenge	Future-proofed zero administration hardware
Bins, Jenkins and Kirlin	Public-key transitional structure	Focused system-worthy analyzer
Heller-Romaguera	Exclusive background conglomeration	Intuitive modular migration
Schmidt LLC	Advanced incremental interface	Reactive dedicated array
Sporer-Corwin	Front-line analyzing implementation	Programmable impactful moratorium
Feest-Feil	Advanced empowering archive	Proactive composite process improvement
Crona and Sons	Intuitive bandwidth-monitored installation	Advanced transitional policy
Anderson, Pollich and Ebert	Persistent cohesive encryption	Vision-oriented real-time superstructure
Adams, Stamm and Witting	Triple-buffered 24 hour access	Assimilated dynamic database
Leannon, West and Cruickshank	Pre-emptive actuating capacity	Enhanced zero administration Graphical User Interface
Keebler and Sons	Realigned value-added neural-net	Assimilated solution-oriented model
Block, Graham and Oberbrunner	Front-line actuating attitude	Pre-emptive 24 hour success
Conroy LLC	Adaptive methodical orchestration	Future-proofed multimedia productivity
Lockman-Bruen	Self-enabling intermediate orchestration	Sharable client-server encryption
Powlowski and Sons	Re-contextualized user-facing firmware	Total 4th generation middleware
Lesch-Swaniawski	Extended zero defect definition	Automated content-based focus group
Brekke-Sporer	Reduced optimal infrastructure	Synergized intangible hardware
Nolan-Fahey	User-centric dedicated portal	Open-architected 24 hour projection
Hickle, O'Keefe and Jast	De-engineered object-oriented knowledge user	Secured systematic website
Goyette Inc	Cross-platform asynchronous ability	Open-source interactive website
Nolan, Turcotte and Thompson	Balanced non-volatile hub	Business-focused exuding moderator
Rohan, Ernser and Botsford	Seamless static task-force	Profit-focused solution-oriented emulation
Corwin Group	Monitored human-resource algorithm	Multi-lateral modular access
Christiansen, Lakin and Abbott	Sharable dedicated customer loyalty	Adaptive reciprocal utilisation
King-Murazik	Right-sized bottom-line paradigm	Digitized composite architecture
Corkery-Morissette	Grass-roots national instruction set	Networked stable toolset
Mohr-Schmidt	Managed zero administration benchmark	Vision-oriented value-added customer loyalty
Hegmann-Hartmann	Persistent regional encryption	Adaptive systemic implementation
Kirlin LLC	Quality-focused secondary definition	Multi-channelled disintermediate migration
Willms-Koelpin	Front-line grid-enabled circuit	Vision-oriented foreground budgetary management
Bernhard-Barrows	User-centric bifurcated strategy	Assimilated systemic software
Kuphal-Barrows	Right-sized client-server open system	Fundamental interactive interface
Turcotte Inc	Switchable 6th generation budgetary management	Seamless full-range task-force
Boehm Inc	Enhanced scalable installation	Open-architected even-keeled flexibility
Reinger, McDermott and Gaylord	Triple-buffered local definition	Profit-focused upward-trending throughput
Swift LLC	Stand-alone neutral framework	Programmable context-sensitive productivity
Pfannerstill and Sons	Organic stable application	Future-proofed multimedia alliance
Armstrong, Gutmann and Stokes	Operative global open architecture	Vision-oriented actuating alliance
Medhurst, Jones and Bernier	Proactive national open architecture	Reduced hybrid knowledge base
Grady-Emmerich	Synchronised grid-enabled support	Optimized multi-state strategy
Champlin-Swift	Inverse didactic budgetary management	Inverse eco-centric groupware
Miller LLC	Reactive systematic policy	Robust asynchronous paradigm
