Palma	Marvin	kole.olson@fadel.com
Monserrat	McKenzie	carley@grimes.net
Frankie	Hermann	johanna.graham@reillybeahan.net
Florine	Watsica	saul.botsford@metzbarton.info
Kristina	Funk	otis.gerhold@murphy.net
Kathleen	Bartell	cristobal_bogisich@blockruecker.name
Glennie	Schamberger	dameon@effertz.com
Elinore	Beer	beau.mosciski@schmelerbednar.info
Erin	Conroy	dell@mills.net
Helene	Parker	michelle.schamberger@rau.biz
Franz	Dickens	wilfrid_medhurst@hickle.biz
Heloise	Satterfield	marina_wintheiser@kshlerinherzog.info
Cary	Bailey	audrey@schaefer.biz
Lindsay	Greenfelder	daryl@dach.org
Herman	Willms	jovani.watsica@cronin.org
Emmitt	Hackett	dangelo.johnson@kiehnschmidt.org
Angela	Flatley	jimmie.mertz@bruen.com
Beth	Zboncak	rozella.leuschke@dubuque.org
Theodora	Kuhlman	margot.kertzmann@champlin.org
Clovis	Pfannerstill	ferne.volkman@stokes.name
Chaim	Haley	zachariah.haley@hoegerprohaska.name
Dana	Hickle	wellington_pouros@dooleyhartmann.com
Earnest	McCullough	jared@nader.net
Fanny	Hegmann	wyman_ruel@ko.info
Alta	Wilderman	victoria.larkin@kiehn.com
Kailyn	Bauch	celestine.hintz@stanton.com
Abdiel	Lakin	edgardo@donnelly.net
Demarco	Doyle	verna@leffler.biz
Graham	Hammes	everett@roberts.com
Camille	Boyle	reynold@ryan.biz
Jairo	Cronin	queen.muller@hettingerkling.net
Vicenta	Muller	kobe@zulauf.net
Axel	Hodkiewicz	josefa.dicki@leuschke.biz
Virgie	Gerlach	ardella@wardmonahan.org
Selmer	Rice	ezra_hegmann@ondrickadavis.name
Ethyl	Rutherford	kristofer@kirlinfunk.org
Hester	Reynolds	ursula_erdman@bode.name
Judah	Kerluke	danyka@kling.org
Kylie	Farrell	louie_mosciski@mclaughlin.org
Lindsey	Davis	brannon@jewe.com
Sienna	Waelchi	erling_koepp@powlowski.com
Caleb	Rice	vincenza.littel@dubuque.net
Rogelio	Thompson	stanford@metz.info
Russ	Nolan	eve@kihnokeefe.info
Isaias	Kautzer	beth_moen@ziemann.org
Lorna	Mraz	jacques.schaefer@jenkins.biz
Nicholas	Towne	isadore@kuvalisbotsford.net
Eduardo	Medhurst	kaya.gislason@reichel.name
Shana	Gutmann	emmitt@schinner.com
Marianna	Steuber	aglae_bernier@paucekskiles.name
Mac	Corwin	kale_crona@beahanortiz.name
Briana	Stamm	tina@ruecker.com
Archibald	Block	herbert_heathcote@hilll.com
Stefan	Swift	kristin.jacobs@keeling.org
Yesenia	Hammes	maymie@feeney.info
Chyna	Bayer	trenton.wyman@treutel.net
Trudie	Erdman	wilson.wilkinson@hermann.info
Arlie	Stanton	reva@fisherbreitenberg.info
Emery	Olson	linnea_smitham@metz.net
Justyn	Jewess	hubert_ferry@crist.net
Jamarcus	Kunde	walton@corwin.net
Cary	Lakin	elvis_trantow@davis.biz
Era	Leffler	david_senger@rutherford.org
Kayden	Boehm	nigel@beier.org
Michale	Roberts	charlie_wisoky@prosacco.info
Melyna	Feeney	merritt_willms@marvincrooks.org
Ella	Rogahn	consuelo.heaney@gerlach.info
Kaya	VonRueden	helen.ritchie@stanton.com
Rachel	Senger	grayson@turner.biz
Carmine	Hirthe	brady.turner@kreiger.biz
Alvina	Becker	oren_hand@wintheiser.biz
Sylvia	Kling	soledad@bernhard.name
Myah	Douglas	london@bogisich.biz
Rebeca	Beer	antonia@schiller.com
Trent	Schmeler	osvaldo_waters@thiel.com
Gavin	Bergnaum	winfield@kiehnlangosh.com
George	Gleichner	roxanne_ernser@dubuquecorwin.net
Kenton	Walsh	rhoda.fisher@mcglynnhickle.org
Beth	Gleason	brice@priceaufderhar.org
Justice	Wuckert	ro@ebert.info
Kayli	Buckridge	rasheed@mohrhilpert.biz
Emilie	Smith	sigmund.thompson@smith.net
Jamir	Terry	malika@cain.biz
Velva	Kreiger	shania.abbott@cummerata.info
Matilda	Mueller	faustino.bins@swiftupton.info
Rosetta	Nicolas	greta_parker@stiedemannortiz.info
Wendell	Rath	ubaldo@hartmann.name
Josue	Gulgowski	cornelius@eichmann.info
Erica	Bins	adolph@marks.net
Antonietta	Terry	tracey_koepp@keeblerstoltenberg.org
Bonnie	Rogahn	lempi@smitham.info
Golda	Will	levi@jacobsziemann.com
Mikayla	Carroll	shaina_leuschke@jacobson.net
Jailyn	Rogahn	colin@stroman.info
Mara	Berge	gina@kreiger.org
Julie	Hintz	jarrett@leffler.info
Rosanna	Weissnat	judah_feeney@baileyledner.org
Katarina	Mante	lloyd_upton@mohr.com
Madison	Erdman	rodger.wiegand@haley.com
Lilly	Cormier	nikita@adams.info
Moses	Feeney	justyn@harris.name
Danny	Gulgowski	chaz_harvey@walterbernhard.biz
Nick	Jaskolski	jaycee@green.net
Freddy	Wilkinson	blaze_breitenberg@fisherkreiger.net
Novella	Schneider	madalyn@hyattboehm.org
Lenora	Heidenreich	leonor.mohr@farrell.com
Quinten	Emard	raleigh_kulas@larsonpollich.com
Reagan	Fisher	lemuel@whitegerhold.name
Reagan	Goodwin	selina.hartmann@moen.name
Foster	Donnelly	loraine@johnson.org
Antonietta	Labadie	lola@lowecarter.info
Wayne	Rutherford	tina@gottlieb.biz
Amani	Leffler	okey.kub@donnelly.biz
Rogelio	Keebler	albina@feest.net
Jana	Hermiston	montana.strosin@nolan.net
Kadin	Franecki	heath_quitzon@olson.biz
Daniella	Mosciski	icie.west@hermann.org
Gino	Gerlach	adolphus_roberts@mitchell.name
Guido	Von	freida.mosciski@willtoy.info
Rocky	Corkery	violette@rempelhahn.info
Bessie	Harber	roy@walkeroberbrunner.com
Carlee	Yost	gretchen_bauch@gibsonweinat.info
Adolfo	Schiller	bettye@williamson.org
Watson	Bode	hipolito@mante.com
Marcel	Yundt	lon_marks@walsh.com
Ariane	Bayer	madelyn@bashirian.biz
Kyra	Gorczany	sofia@langworth.com
Jazmin	Lueilwitz	chloe@nicolas.name
Brandi	Gerlach	verona@lowemoen.net
Zetta	Ernser	bernadette@klein.name
Alva	Thiel	blaise@reilly.info
Philip	Witting	isai@predovicbaumbach.biz
Annamarie	Schaden	michel@hudson.biz
Jo	Gorczany	jedediah@bruen.name
Kim	Jakubowski	else@breitenberg.info
Carey	Auer	reyes@mosciskiheidenreich.org
Georgiana	Wintheiser	margret_volkman@braunleuschke.biz
Jayden	Bosco	omari@pfannerstill.name
Clyde	Collins	rogers@collier.name
Bettye	Metz	kasey_torp@heidenreich.net
Meagan	Beier	marlin@yost.info
Alexane	Wilkinson	ettie@schowaltermacejkovic.com
Gus	Ankunding	demarco@skiles.biz
Ceasar	Boyer	aidan@kochbartoletti.name
Emie	Reilly	jett.abshire@gleichner.net
Dean	Terry	kristoffer@denesik.biz
Jaeden	Bashirian	wilson_nicolas@smitham.info
Tommie	Kuhn	therese@feest.biz
Monserrate	Gutmann	buddy@raynor.info
Van	Keeling	doyle@haley.org
Agnes	Aufderhar	murphy@crookswunsch.net
Audra	Weimann	armando@kuphal.biz
Terrence	Brekke	kolby@osinski.name
Sasha	Gutkowski	fannie@kozey.com
Lambert	Hansen	felipa.jaskolski@gutmannaufderhar.org
Orland	Vandervort	jonas_moriette@friesenbernier.org
Isai	Huel	magnolia@schultz.info
Jesse	Roberts	matilde_anderson@rempel.com
Carmela	Eichmann	marcos@rippin.org
Karl	Hintz	meaghan@keeblerbechtelar.com
Darian	Gibson	ryan@nienow.info
Marina	Ernser	darian.boehm@padberg.info
Pauline	Renner	glenda@carroll.net
Paula	Lemke	emmitt.dickens@spinka.info
Audrey	Krajcik	weldon_pacocha@dickens.org
Arjun	Stoltenberg	karlie@zemlak.com
Hubert	Keebler	elisa.lind@stoltenberg.net
Oran	Gerlach	humberto@connellywunsch.biz
Emil	Rau	adelbert.upton@bailey.net
Laisha	Welch	junior@zemlak.org
Michaela	Ullrich	emilio@kulas.net
Asha	Schuster	aliya@miller.name
Christa	Heller	citlalli@abernathy.com
Sienna	Fisher	addison_roob@effertzwilliamson.net
Rashad	Mueller	mollie.homenick@brakusdouglas.com
Salvatore	Barrows	paul_cormier@schillerrempel.net
Deja	Kreiger	raymundo@vonruedenlabadie.com
Delores	Kunze	lucious_mills@luettgenortiz.name
Hobart	Wolf	andy@kozeysanford.biz
Jayden	Langosh	webster@west.net
Wayne	Jewess	constantin@johnson.info
Grant	Marks	jazmyne.littel@bayer.com
Jermain	Batz	jamil@orn.biz
Laisha	Kassulke	alexandria@danielharber.com
Constantin	Kuhn	malinda_adams@hettingerzieme.name
Jaqueline	Herzog	marian_hirthe@nienow.info
Leann	Heller	vicenta@crona.name
Braeden	Nolan	zora.waters@koepp.com
Abagail	Hartmann	michele@weimannthompson.name
Lucius	Upton	simone@jakubowskipollich.biz
Jeremy	Zulauf	danyka@dibbertgrant.net
Jackie	Hane	mathilde@bayer.net
Sister	Satterfield	immanuel_kemmer@keler.name
Dallas	Ankunding	sheridan.blick@hackett.org
Dell	Kautzer	jasen_bradtke@krajcik.name
Michel	Zemlak	harvey@johns.name
Jamir	Runolfsdottir	elena@denesikbarrows.org
Claudie	Torphy	verda@sanfordwilderman.org
Regan	Nienow	leo@leffler.org
Julius	Steuber	miracle_bradtke@schmeler.biz
Emmy	Bechtelar	molly.fahey@colejohnston.org
Sanford	Gaylord	enola@robelrogahn.name
Aracely	Dicki	iliana@reynoldsglover.net
Eleazar	Mitchell	augustus_lind@mraz.net
Ernie	Osinski	joanie@wehner.org
Dean	Howell	evans_hilpert@jakubowski.info
Gladys	Rempel	emily@sauer.biz
Shaylee	Mitchell	ferne@blandagerlach.com
Bernard	Erdman	ruben@feeney.info
Einar	Witting	manley@auer.com
Joelle	Goodwin	skye_stark@borer.info
Jeremy	Wuckert	katlynn_beier@raynorwillms.org
Emely	Legros	santos@botsford.info
Anabelle	Nitzsche	mitchel@oconnellhomenick.info
Queenie	Graham	sophia@mills.info
Wendy	Goodwin	raoul@hirthe.biz
Lucile	Hansen	nolan_cruickshank@kuhlman.biz
Alexys	Altenwerth	ardella@murray.name
Madison	Daugherty	jay_abernathy@lind.net
Salma	Bernhard	lee.langworth@mante.com
Jensen	Okuneva	emory@lakin.com
Summer	Block	walton_beahan@sauer.com
Angie	Flatley	thalia@bailey.info
Makenzie	Schmitt	gielle.ohara@goyettelittle.biz
Ava	Gorczany	jana_kuhic@cremindaniel.net
Wallace	Price	santiago_paucek@starkkeebler.com
Guiseppe	Pacocha	ethyl@nikolaus.name
Herta	Monahan	alanis@rogahn.net
Cierra	Trantow	jed@larson.net
Georgianna	Goodwin	amely_spinka@jacobs.com
Tracy	Metz	lurline.hoppe@bartoletti.com
Scottie	Ratke	abigale@auer.name
Jessica	Hyatt	jerrod@hagenechuster.biz
Rahul	Balistreri	celestino@wisozk.org
Alessandro	Aufderhar	ena.kautzer@robelkutch.name
Krystel	Flatley	mario@huel.net
Dena	Weimann	cale@murphy.biz
Antonetta	Bednar	johanna_west@collier.biz
Linnie	Harris	ora@kerlukeconn.net
Ettie	Dach	caterina_leannon@dach.net
Marlene	Vandervort	anika@jakubowski.info
Ricardo	Satterfield	sally.price@mosciskismitham.name
Stewart	Rath	winnifred@wiza.biz
Melody	Thompson	josephine_shields@gutkowski.net
Fritz	Runolfsson	fleta@ratke.com
Kendall	Tillman	arturo.veum@keler.net
Mertie	Runte	jacynthe@robel.com
Della	Schamberger	laurence@trantowpacocha.biz
Maryjane	Hermiston	royal@gutmann.net
Karson	Fay	amelie.goodwin@schaefer.com
Sedrick	Mante	ubaldo@mayert.biz
Darrel	Bechtelar	andres@nienowmorar.org
Marco	Altenwerth	joany.rutherford@nitzsche.name
Nikki	Schamberger	bernita@dubuque.org
Celia	Daniel	ruben.larson@braun.biz
Ebba	Abshire	jerod.zemlak@witting.name
Casandra	Rau	tatum.nolan@greenkulas.biz
Scot	Stark	tatyana@bradtkethompson.org
Americo	Marquardt	stuart_lowe@kertzmannmuller.com
Zander	Koch	jonathan.johns@rempel.net
Sydnee	Heidenreich	damon@blanda.com
Adonis	Ward	nadia@williamsonbahringer.name
Leopoldo	Walter	kiel@rueckerkilback.org
Alexandria	Lemke	shaniya.nolan@reichertbernier.name
Dean	Kiehn	gabriel.sawayn@treutel.org
Mozell	Kertzmann	claudie.hansen@roobschroeder.info
Trenton	Goyette	caden@lebsack.net
Kristin	Wiza	evie@oconnell.info
Deshaun	Rice	joey_nicolas@murazikrice.info
Ryleigh	Collier	stuart_weimann@runte.org
Cheyenne	Parisian	margie@jaskolskiokon.net
Nakia	Fadel	jerry_howe@ruecker.com
Tyree	Little	else@ledner.com
Cedrick	Orn	ines@pacocha.biz
Granville	Parisian	isabella.strosin@tillman.biz
Scarlett	Altenwerth	deonte@douglas.net
Sonny	Beatty	fleta_runte@schulist.net
Diana	Stanton	lillie@bergnaumkiehn.com
Drew	Walsh	breanne_goodwin@hettinger.info
Mattie	Auer	maribel@okonwolf.org
Rodrick	O'Keefe	margarett@altenwerth.info
Henri	Douglas	vernice@moore.info
Chanel	Hackett	irma@mueller.org
Karlie	Abbott	maxwell@huelsdicki.com
Aleen	Turcotte	bernadine_collins@pouros.info
Harvey	Von	zora@abshirejohnson.com
Stephany	Gleichner	marley@gulgowskimante.name
Gregorio	Bartell	urban_streich@simonis.com
Ubaldo	Satterfield	dorian_aufderhar@mante.biz
Cayla	Harris	avery@torpdare.name
Lilyan	Metz	verla.will@schulist.biz
Carmine	Lubowitz	zechariah@tremblay.net
Tatum	Lubowitz	katelynn@schustersawayn.info
Kameron	Walsh	josefa@lubowitz.info
Karlee	Hansen	brant@hartmannzulauf.biz
Melany	Bednar	brandyn@spinka.name
Weston	Stoltenberg	lance_mueller@borer.net
Lafayette	Reynolds	greyson.volkman@kris.info
Herminio	Romaguera	rico.hermann@bosco.com
Jabari	Leuschke	barbara_ohara@kuvalisko.info
Reinhold	Harris	theodore@bashirian.net
Kimberly	Larkin	aurelia@satterfieldstreich.com
Effie	Hettinger	solon@koelpinsporer.name
Fabiola	Ortiz	emanuel@kuhndoyle.biz
Maryse	Russel	bernard.zboncak@rueckerbruen.com
Demetris	Bogisich	lucas@bodemann.org
Jacques	Wiegand	ignatius@boyle.info
Cathryn	Kuvalis	esperanza.dare@jasttorphy.name
Dedric	Bartell	benjamin@damorepaucek.org
Cleveland	Bashirian	carley@klocko.info
Claud	Dooley	celia@orn.com
Edythe	Barton	vella@daugherty.org
Veronica	Reichert	florine_vandervort@ruel.org
Gisselle	Cole	garett@pfannerstill.name
Garnett	Christiansen	francisca.deckow@abshire.com
Norma	Langosh	letha_bednar@lemkemoen.net
Murl	Zboncak	golden@bartellbode.biz
Hubert	Swift	price@hermannboehm.info
Arvilla	McCullough	bailee@schneidermiller.com
Eva	Simonis	lorenzo@kshlerin.com
Arnold	Pfeffer	casimer@brakus.info
Veronica	Nitzsche	leo@aufderhar.biz
Dillan	Senger	maxie_gaylord@borer.info
Khalid	Lockman	woodrow@mayerthintz.com
Tina	Dickinson	ines_kunze@hageneshayes.biz
Amber	Moore	dominique.littel@ernseremmerich.biz
Paolo	Kling	abby@labadiegutkowski.com
Shayna	Pacocha	marty_pacocha@stromanritchie.name
Cali	Berge	alia_reinger@watsicabotsford.net
Wilfred	Stark	eden.hintz@gulgowski.net
Willard	Murazik	keith@gottlieb.com
Madisyn	Murazik	odea.fahey@smitham.biz
Blaze	Kuhn	anita_conroy@rolfson.net
Alfred	Collins	noe.larson@ricekiehn.com
Constance	Muller	evelyn@feeneyjast.org
Heather	Sauer	fredy_swift@mertz.info
Devonte	Bartoletti	lizzie.kreiger@goldnerhuels.info
Susanna	Gaylord	jeffry_mayert@jacobs.org
Bulah	Hansen	agustin.heidenreich@kubconroy.info
Brayan	Cartwright	dayton@funkmclaughlin.net
Friedrich	Schneider	malika@trantow.org
Marta	Labadie	geovanni.glover@waterszulauf.net
Paris	Walker	rozella@gislason.biz
Esta	Cole	johnson@keeling.biz
Ada	Hilll	dolly@mclaughlin.net
Elton	Ledner	adolph@raynoremmerich.biz
Timothy	Boyer	green@schulisthoppe.name
Joannie	Leannon	lucas@sawaynthiel.name
Lisa	Hills	mathilde.kirlin@rutherford.info
Fermin	Bartell	sarah@lemkeferry.net
Destany	Denesik	kayla.nader@langworthlittel.info
Jordyn	Jewess	kale.beatty@lemke.com
Marlee	Balistreri	bridgette@lebsack.info
Rafael	Hoppe	eldred.barrows@terryswift.com
Caitlyn	Kulas	jeanie@oconnellreinger.info
Orpha	Kemmer	darby_pfannerstill@hintz.com
Keshaun	Welch	carter.rowe@predovic.name
Lessie	Aufderhar	chelsea@tremblay.info
Olga	Roberts	aleen@weinat.info
Ally	Collins	freeman.schulist@goodwin.org
Yasmeen	Krajcik	aleandra_marvin@torphyabernathy.biz
Marcia	Watsica	darien@mosciskiwolf.info
Ila	Witting	adell.langworth@pfannerstill.name
Rae	Leuschke	robin_graham@wyman.com
Deron	Waters	khalil@murray.biz
Ole	Toy	roberto.fadel@durganmayert.org
Nia	Windler	jaren_bartell@bosco.info
Clemens	Bauch	cortez_bartell@adamsbauch.biz
Vladimir	Kihn	orland@smithschuppe.info
Kaylie	Paucek	marcelle.wyman@jenkinsmohr.biz
Dalton	Towne	london@kling.com
Whitney	Balistreri	norbert_schumm@monahanlindgren.name
Hannah	Flatley	kurtis@oberbrunnerhermann.name
Name	Dickinson	kelsie@connelly.com
Esteban	Jones	jace_harris@hahnwiza.org
Lysanne	Lubowitz	emil@sengerbecker.name
Arnulfo	Russel	otho.hamill@dietrichadams.org
Daphney	Zboncak	katlynn@kling.name
Jarred	Barton	curtis@green.com
Zita	Yundt	lucas@ebert.org
Kevin	Gottlieb	nels@feeney.net
Jasmin	Friesen	aida@hills.biz
Esperanza	Abbott	mya@jakubowski.biz
Derick	Wilkinson	keeley@rippinryan.com
Clair	Bergnaum	arlie@smith.com
Matt	Schultz	floyd@harvey.com
Dayton	Bauch	camylle@kris.com
Fermin	Cassin	letitia@ohara.org
Juliana	Bechtelar	junior_hauck@nitzschelakin.info
Moises	Marvin	amara.grimes@heathcoteconroy.net
Aisha	Mayert	leone@douglas.net
Anissa	Schiller	burley@greenholt.org
Delia	Durgan	jeremie.tromp@christiansen.net
Tristian	Mraz	breanne.murphy@runte.info
Hershel	Keeling	jerod_eichmann@bergstromoconnell.biz
King	Reichel	anderson@boyerbernhard.biz
Hailee	Howe	caria.bartoletti@predovichowell.biz
Casandra	McCullough	jesus_bartell@sporer.info
Lucius	Kirlin	gabrielle@feil.biz
Donato	Cormier	sydni.okon@buckridgenikolaus.info
Reva	Luettgen	alanis_collins@rath.info
Jovany	Metz	haley_heel@mohrharber.com
Jonathan	Ortiz	sabryna@terry.info
Lori	Lesch	sylvia_stamm@hudson.org
Nina	Schaden	mayra@schoenbeatty.net
Hoyt	Von	montana_von@frami.info
Erica	Mayert	newton@vonrolfson.net
Bridgette	Reichel	reese@eichmannbruen.com
Deven	Powlowski	malika_okeefe@mayert.com
Vince	Blick	hope_kuhic@mills.biz
Kallie	Kuhn	josue.adams@keebler.biz
Nico	McDermott	deborah@haneortiz.net
Sandra	Casper	lavada@oconnell.net
Melisa	Ankunding	conrad_sauer@lemkehowe.info
Shemar	Wiegand	ciara_schumm@anderson.biz
Raymond	Langosh	keeley@uptonhuels.name
Effie	Skiles	wilfredo_rogahn@metz.biz
Maiya	Ward	murphy.berge@bauch.name
Marilou	Muller	ricky@stiedemanndubuque.net
Omari	Reilly	jeyca@emardheel.biz
Kelli	Fadel	marie.ziemann@nicolas.info
Tanya	Fritsch	maudie@bernier.name
Lonzo	Kovacek	lucinda@jenkinstremblay.net
June	Dickinson	malika_schultz@boehm.info
Arely	Medhurst	landen.mosciski@stamm.net
Kelvin	Hettinger	xander_rippin@leffler.biz
Amina	Larson	domingo@kunde.net
Marcel	Stoltenberg	ruthe@bradtkeweber.name
Bertrand	Aufderhar	ervin@powlowskirunte.com
Columbus	Larson	aric@gutkowski.net
Devan	Powlowski	araceli@miller.net
Skyla	Wehner	allie@fahey.org
Gudrun	Roob	newton.mills@bernhard.info
Joany	Lakin	karine_veum@hoegermcclure.info
Zita	Stokes	candace@wisozklittle.com
Lucious	Dibbert	elroy_cruickshank@casper.name
Fausto	Wilderman	jey@paucekwilderman.net
Garett	Kuhic	lori@koepp.name
Amie	Johnson	al.pollich@strosin.com
Mac	Rutherford	hank@hermann.org
Christophe	Lakin	olin@boyer.name
Rollin	McGlynn	mervin@white.name
Joey	McKenzie	meredith.mraz@boyle.org
Cornell	Becker	obie@champlin.org
Veda	Hessel	adeline.stanton@rowe.com
Jameson	Maggio	lisette@ko.org
Price	Roob	darian@grant.name
Elena	Pouros	bud.hahn@kautzerdenesik.org
Ashleigh	Becker	lionel_kirlin@frami.org
Jakayla	Kreiger	kody@romaguera.org
Charity	McDermott	emery@brownframi.com
Ludwig	Jacobi	elsa@goldner.name
Reagan	Lynch	stewart@gutkowskiankunding.net
Floyd	Carter	nyasia@hettinger.info
Henderson	Schuppe	ronny@schuster.info
Dan	McDermott	tony.heel@jenkinsheel.com
Lizeth	Bosco	favian@kuhic.info
Leonel	Davis	roberto@gulgowskimorar.com
Nat	Dickinson	colin@haag.com
Korbin	Green	jamal.kuphal@dicki.org
Alvera	Koch	dameon.gusikowski@rohanbauch.name
Regan	Hane	gus@swift.name
Lola	Konopelski	lois@hoppebayer.biz
Dasia	Marks	carley@cole.name
Belle	Lehner	shakira@mueller.com
Charlie	Mante	vito@wilderman.org
Antonette	Treutel	dianna@wolff.com
Chelsie	Funk	edgar@rosenbaumschamberger.info
Orpha	Schulist	arden@raynorbartoletti.net
Coty	Metz	jovany_mertz@schowalter.net
Adelia	Mosciski	ethelyn.lowe@gleichner.net
Cara	Larkin	kailyn.hilpert@witting.biz
Alene	Grimes	jane.blanda@roberts.com
Golda	Cormier	adolph@becker.biz
Jordi	Von	deonte.fahey@wiza.net
Antwon	Crist	haley.bradtke@gutkowskistehr.com
Enid	Volkman	kamryn@mills.org
Preston	Hills	karl_eichmann@reichertschaden.org
Joyce	Carter	wilber_klein@schroederbecker.biz
Mandy	Johnston	alexzander@batzharris.name
Enoch	Littel	thomas@rohan.com
Caesar	Heidenreich	cordia.johnston@bayer.net
Alyce	McClure	raven.schmeler@luettgengulgowski.info
Dax	Borer	creola_sanford@ernsersauer.name
Adell	Bechtelar	jovanny@harris.info
Marietta	Feeney	damaris@bergstrom.info
Eileen	Hermann	dennis_marks@prohaska.name
Orie	Carter	chad_zemlak@heaney.org
Tom	Lind	adriel_schumm@carroll.info
Elisabeth	Haley	hubert@mraz.info
Berry	Zieme	clay_anderson@conn.org
Alene	Welch	savion.heller@blick.biz
Dee	Bahringer	agnes@gorczany.info
Madge	Skiles	bruce_stanton@davisfahey.com
Jeanne	Kassulke	arno@klocko.biz
Garland	Mills	jarvis@howell.name
Osbaldo	Volkman	keven.swaniawski@hilpert.com
Stone	Brakus	mariam@jacobsonrunte.net
Nelle	Cremin	pearline.langosh@ruel.net
Clotilde	Deckow	mathilde@dubuque.org
Bret	Rodriguez	judge@cartwright.info
Lina	Jenkins	ron.bednar@boehm.com
Amir	Friesen	carroll.walsh@von.name
Cassandra	Dickens	gerson_mohr@nolan.biz
Orlo	Waelchi	marilou@jacobs.com
Johnson	Bernier	josephine@olson.net
Kamren	Armstrong	jamison_mills@anderson.net
Logan	Ritchie	carlee.stamm@sipesrogahn.info
Rhett	Jerde	vella@rogahn.biz
Elsie	O'Connell	emelie.hickle@mannstark.net
Sadie	Bashirian	candace_hodkiewicz@ritchie.name
Cletus	Olson	camron.schmeler@rippinstehr.biz
Jeanne	Bauch	palma.wintheiser@osinski.biz
Patience	Stiedemann	noble@zemlak.biz
Lewis	Sipes	oswaldo@boyle.org
Monserrate	McGlynn	hector.bednar@franecki.org
Aiyana	Bayer	pietro.hammes@murphyweinat.net
Mina	Kshlerin	cletus_shields@welchjacobson.name
Joshua	Fadel	jack@fisher.name
Javier	Braun	zachary_hermann@kirlin.com
Cecelia	Feil	delaney_emmerich@reichel.name
Tiara	D'Amore	henry.goyette@wehner.org
Bernard	Schroeder	fredy@blandaturner.info
Julia	Block	sarina.lueilwitz@sanford.org
Hassan	Boyer	kaya@morar.biz
Arvid	Blanda	mackenzie_walter@mannmonahan.com
Burdette	Schiller	americo_rowe@herzogwisozk.com
Llewellyn	Hansen	julien.hilpert@weimann.biz
Johnny	Metz	kamryn.rath@hermiston.biz
Eldon	Beer	citlalli_nolan@weberlangosh.net
Mona	Beer	dashawn.hahn@buckridge.name
Constance	Heidenreich	cruz_boyle@windleremmerich.biz
Skylar	Leffler	trent.turner@lefflermayer.com
Jacinto	Hoppe	justina_bayer@goodwinschumm.net
Melyssa	Champlin	rosetta@andersonklein.net
Julian	Jewess	casey@vonrueden.biz
Ignacio	Hartmann	macey@schinnerhermann.net
Esperanza	Beahan	miouri_jacobson@ko.com
Elyssa	Leuschke	freddy.quitzon@wilderman.net
Gladys	Bode	rigoberto@christiansen.biz
Alvah	Thiel	omer@volkman.info
Billy	Kohler	geraldine_price@leuschkekonopelski.org
Myrna	Price	madelynn@eichmannlegros.net
Harold	Gaylord	mandy@lebsack.biz
Josie	Ruecker	hillary@quigley.org
Evelyn	Wiza	devante@grantfeil.com
Vance	Morissette	frederique.nicolas@moen.info
Asa	Kessler	anjali@swaniawski.net
Mandy	Leffler	gerry@torphy.org
Morgan	Larkin	misty_kris@cartwright.name
Zackary	Weissnat	nickolas@ratkeondricka.net
Ole	Morar	henri@wisoky.net
Jaquan	Wolff	alisa@kuhlman.org
Delfina	Stark	laney@beahan.com
Andreanne	Hickle	aryanna@smithweimann.net
Moses	Wolff	jackson@ebertgreen.name
Edd	Nader	lia.donnelly@walsh.net
Mason	Hirthe	oswald@ondricka.org
May	Rau	margaret.hintz@bogisich.net
Jensen	McLaughlin	alisha.dooley@kertzmannkreiger.net
Mabel	Romaguera	elton@hagenetamm.info
Mose	Terry	lenore_anderson@huels.net
Virgil	Turner	roger@mcglynn.info
Frances	Veum	chet_rau@denesiklynch.biz
Therese	Gleason	alyson@corkery.info
Darlene	Weber	belle.huel@jewe.com
Dorris	Considine	roma@parisian.com
Lizzie	Dickens	elia.lueilwitz@wisozk.net
Willow	Becker	walter.streich@skiles.net
Donnie	Kreiger	keaton.ritchie@mosciski.info
Keyon	Bernier	jean.mann@volkman.biz
Nicholas	Kihn	hollie_hills@cummerata.info
Cordie	Kovacek	friedrich@breitenbergthompson.biz
Margie	Lowe	mariana_eichmann@klein.name
Aimee	Predovic	ania_legros@kuvalis.info
Marilou	Jacobs	marielle_hickle@feilyundt.info
Vladimir	D'Amore	amani@walkermclaughlin.info
Schuyler	Bechtelar	camila.lang@braunroob.net
Markus	Connelly	chaz.halvorson@mayertstoltenberg.name
Sylvia	Thiel	trevion_zieme@waelchiwolff.biz
Salvatore	Stark	keshawn_deckow@ryan.name
Renee	Hermann	casimer_prosacco@schultz.biz
Blaze	Schuppe	erna@crona.biz
Abbey	Wilderman	alayna@shieldshegmann.name
Weldon	McDermott	jennifer@beerwilderman.info
Christophe	Skiles	nels@williamsonrosenbaum.info
Arjun	O'Hara	magdalena.becker@rippin.biz
Cecil	Marvin	gage_huel@donnelly.org
Tod	Botsford	lilian@volkmangoodwin.com
Jenifer	Corkery	cydney@funk.org
Carmella	Frami	meggie_reinger@mayerwiegand.biz
Micheal	Kutch	shany.ullrich@beier.org
Lorenz	Wunsch	britney_botsford@harris.net
Elmer	Herzog	salvatore.graham@orn.com
Nya	Sporer	keyon_cain@heel.info
Eldred	Hammes	raina@schmittparker.biz
Godfrey	Altenwerth	jorge_volkman@hamill.net
Emma	Schneider	daren@turcotte.info
Jacinthe	Streich	tommie@goodwin.info
Taya	D'Amore	carolyne.lakin@gutkowski.org
Mariela	Torphy	doris@quigley.org
Dena	Langworth	minnie.shields@sanford.info
Lilliana	Morissette	oran@hahn.net
Mohammad	Nicolas	horacio@moriettewiza.com
Marcelina	Cronin	claudine.mills@mcglynn.biz
Christopher	Daniel	delbert@kreiger.info
Josie	Purdy	devan_hickle@kuphal.info
Samantha	Greenholt	shanon_crona@kautzer.org
Landen	Ziemann	ava@murphy.org
Bethany	D'Amore	doris@gusikowskithompson.info
Bradford	Roberts	garrett@ruecker.net
Lindsey	Eichmann	jimmy.hyatt@murphy.com
Vernie	White	meredith@bradtke.com
Zackery	Frami	cynthia@beatty.biz
Jaron	Blick	dayne.steuber@toyboyle.name
Sylvester	Heidenreich	estel_cole@cronaokuneva.name
Wilbert	Lind	beryl@swift.net
Anika	Konopelski	devan_rodriguez@reynolds.net
Sean	Rowe	cody@hilll.com
Sarah	Lubowitz	stephany@dare.info
Melody	Bergnaum	amani@lindgrenkuphal.name
Kayley	Schultz	dominic@barrowswiza.net
Jamel	Haley	ivah.lesch@schroeder.com
Duane	Bartell	alfonzo@keelinghaag.biz
Lizeth	Feest	shemar.langworth@lowesatterfield.org
Guy	Buckridge	charley@west.net
Stanford	Parisian	vallie.jerde@mayer.name
Laurianne	Toy	israel@thompson.net
Ashleigh	Stracke	quinn.crooks@quitzonwunsch.name
Aubree	Sauer	adam@hoeger.org
Catalina	Hahn	manuela@wiza.com
Glenna	Waters	jameson@naderhuels.com
Ladarius	Larkin	adah@kuphal.com
Jon	Berge	earnest_upton@hermansipes.biz
Kristopher	Konopelski	ansley.macejkovic@kerlukedickens.com
Dylan	Braun	evan.wilderman@casper.name
Maritza	Tremblay	brant_dach@mckenzie.info
Mazie	Botsford	delphine_hayes@buckridgehowe.net
Imogene	Lockman	pascale_thiel@cremin.name
Lora	DuBuque	elroy@brekke.name
Colton	Mraz	ottis.schimmel@keler.info
Cullen	Gerhold	josianne.glover@paucek.org
Stanley	Sporer	nick.lang@corwin.com
Shawn	Aufderhar	anabelle.leannon@tremblay.org
Spencer	Zulauf	kane@schmidt.biz
Ricardo	Moore	martine@schowalter.info
Emile	Lemke	lowell@collier.biz
Dorothea	Anderson	reed@herzogabbott.biz
Roslyn	Nienow	ellsworth_armstrong@ziemannzemlak.net
Giovanni	Hegmann	jacinthe@abbott.org
Edmond	Gerlach	beaulah@ratke.net
Lambert	Leannon	kane@rutherfordrunte.net
Daphnee	Barrows	tamara.bernhard@howe.net
Francesco	Monahan	norval@quitzon.net
Reba	Barrows	raheem@sporerhaley.com
Keely	Lubowitz	arnulfo.miller@mills.biz
Palma	Senger	ola.crist@kohlerrau.biz
April	O'Reilly	jonathon@steuber.com
Elyse	King	koby_grimes@jerdeeffertz.net
Adolfo	Pfeffer	akeem@kreigerconnelly.biz
Kitty	Turcotte	aleandra@rosenbaum.biz
Florida	Ortiz	garnet_rutherford@little.org
Rita	Abbott	hermina@harris.com
Trever	Heaney	kasandra_borer@handfranecki.net
Silas	Fahey	aylin@mohr.org
Micah	Stanton	maximo_metz@feeney.org
Cristobal	Homenick	arne@graham.name
Keshaun	Ratke	kody.fay@hammeswalsh.info
Ava	Nader	donnie@buckridge.org
Dion	Romaguera	antonette@kemmer.net
Hayley	Douglas	jabari_rath@bergnaum.org
Annabell	Champlin	jacklyn@stehr.net
Joan	Schroeder	laurianne.wisoky@altenwerth.org
Clement	Batz	stephanie@mcglynn.org
Courtney	Kuvalis	maxime@monahan.net
Sheridan	Abbott	marques@lakin.name
Margie	Johnston	valentine@lesch.org
Autumn	Nader	kaya@morar.name
Yazmin	Pagac	jaida_marvin@collier.name
Immanuel	Hills	irwin@towne.com
Jerrod	Howe	amalia_oconnell@lakinheel.org
Ashleigh	Walker	enoch@barton.info
Victor	Brown	dino.fahey@collier.biz
Donavon	Hegmann	katrina@marvin.info
Katharina	Gleichner	vincenza_huel@starkhayes.biz
Bo	Johnston	jeromy.johnston@swaniawski.com
Petra	Upton	montana_feil@glover.net
Cordelia	Kemmer	isabella@keebler.org
Emely	Ryan	tomas@jaskolski.org
Coy	Rippin	crystal_sauer@schuster.biz
Haleigh	Hessel	dudley_grady@wyman.com
Katelin	Bruen	dawn@hettinger.name
Jadon	Predovic	baron.wilkinson@franecki.info
Donnie	Bartell	amie@spinka.net
Loma	Orn	liana@davis.biz
Abigale	Pfeffer	horace.harris@lindsteuber.name
Estel	Volkman	isabell.kertzmann@heel.org
Dane	Kilback	devante@lockmanhirthe.info
Norwood	Kreiger	dahlia_crona@erdman.net
Keaton	Rippin	joana_jacobs@jerde.net
Alexane	Fadel	darwin.gutkowski@kilbackjakubowski.com
Melvin	Harber	bruce@hoppe.com
Charles	Hickle	daphne.kris@thompson.net
Jarrod	Rowe	fausto_hand@bergecrooks.net
Marlene	Lang	kenneth.pfannerstill@bogisich.info
Nathan	Turner	aida_armstrong@spinka.net
Keenan	Green	ulises.hermann@keeling.info
Rhoda	Dicki	dasia@reichel.name
Demario	Kub	turner@larson.net
Tremaine	Heidenreich	alexandrea.ullrich@bashirian.info
Kirk	Block	alphonso@padbergmcclure.biz
Lester	Armstrong	elroy_becker@jeweupton.org
Joannie	Marquardt	raina@schmidt.net
Berniece	Cassin	marcia.gottlieb@ondricka.net
Paris	Bins	modesta@cartwrighthuels.org
Barry	Mayer	madelynn@jacobi.org
Chase	Powlowski	deie@stamm.info
Ivy	Dickinson	corene.rath@gaylord.net
Wilma	Kozey	curt@jones.info
Eloise	Prohaska	mireya.reichert@schowalter.net
Roman	Hoeger	joannie.murphy@ortiz.com
Alexandrine	Will	raven.konopelski@dibbertcorkery.com
Clifford	Lowe	janae@welch.com
Friedrich	Robel	liana.kub@andersonbayer.com
Juana	Feil	drew@okuneva.org
Emery	Keebler	annabelle_prohaska@nicolas.net
Bianka	Hamill	dolly@veum.net
Emerald	Stehr	lucius@schiller.info
Abigale	Morissette	dasia@witting.info
Verla	Wilderman	caden_white@nader.com
Alexandro	Thiel	mina.kautzer@johnstongerlach.com
Osbaldo	Reilly	amanda_murphy@klein.info
Gayle	Padberg	jaunita_bahringer@brekke.info
Wade	Bauch	lydia@kshlerin.net
Emmanuel	Runolfsdottir	daphney.ortiz@lind.net
Herminio	Rau	neil.welch@leannon.name
Harley	Price	ibrahim@zieme.org
Scottie	Moore	agustina.fahey@ratkemante.org
Randi	Dickinson	karley@boyerkoelpin.net
Clarabelle	Vandervort	sofia@dooley.info
Shawn	Trantow	presley_ziemann@effertzschowalter.biz
Domenic	Spinka	roosevelt_crist@klockohayes.biz
Jennings	Dach	macy_hills@bergstrom.com
Aileen	Feil	jordyn_nader@hintz.net
Abdiel	Nitzsche	marjorie.lynch@brekke.net
Mya	Hartmann	marlon@mills.biz
Lilla	Feil	amie_johns@jakubowski.name
Lauryn	Purdy	chanel@ebert.biz
Aglae	Zieme	arnold.schulist@leuschke.info
Jevon	Marvin	columbus@luettgengaylord.biz
Osbaldo	Pfeffer	antoinette@heel.name
Lesly	Kshlerin	kaycee@mcglynnbatz.org
Hettie	Mraz	jada.altenwerth@greenholt.com
Aletha	Jerde	alfred@torp.com
Robbie	Brown	maryse@predovic.com
Maxime	Macejkovic	providenci.schaefer@stracke.biz
Vickie	Douglas	grace_daniel@doyle.biz
Donald	Harber	jodie@rath.name
Elza	Haley	lonnie@rosenbaum.name
Gardner	Wuckert	irwin@schaefer.org
Jannie	Will	carol@littel.org
Darby	Dicki	kadin@shanahan.name
Desiree	Kemmer	reginald.green@lowe.name
Rafael	Moen	maximo_okuneva@braunturcotte.com
Sally	Graham	liana.christiansen@quigley.net
Furman	Hyatt	carmen@nitzschecollins.info
Lolita	Davis	jillian_kerluke@huels.com
Maci	Thiel	asa_kshlerin@hegmannwindler.name
Oceane	Johnson	jennie.schulist@hauck.org
Ramona	Bechtelar	mateo@trantow.info
Emory	Volkman	maritza@rennerkaulke.org
Isobel	Lakin	alexys@carter.com
Twila	Gorczany	candelario.powlowski@schimmel.org
Woodrow	Hammes	rosa@hansen.com
Osvaldo	Jacobson	ada@ryancain.name
Jaeden	Carter	valentine.braun@ebertlesch.net
Ethyl	Heathcote	barbara_dickinson@quigley.com
Kenny	Cronin	dax.leannon@watsica.name
Dylan	Berge	mia@mertzhuels.net
Dariana	Koch	layla_bayer@lebsackwhite.com
Trent	Beier	geo_paucek@weber.name
Turner	Hegmann	kaelyn@fahey.org
Lucinda	Hintz	bryana_durgan@grimes.net
Kristina	Luettgen	mariane_mraz@heaneyschulist.com
Nat	Crist	giovani@jast.biz
Elna	Emmerich	vita@luettgenspinka.info
Myrtle	Block	zena.miller@connhalvorson.biz
Jedediah	Predovic	verna@johnson.net
Kristy	Lueilwitz	lula@jeweschuster.name
Kareem	Schaefer	victor@vonruedenwiegand.biz
Sandrine	Jerde	dwight@danielstracke.info
Brady	D'Amore	cruz@botsford.net
Waylon	Jacobi	lorenza@ernserheller.biz
Louie	Lind	rocio_schaefer@hickle.biz
Stephany	Romaguera	alexandro@greenfelder.biz
London	D'Amore	hadley_pfeffer@mohr.name
Leopoldo	Botsford	cielo@swift.org
June	Carroll	clark@bernhard.com
Paxton	Cremin	taurean.hilpert@kutchgrady.net
Waldo	Turner	darby@sawayn.info
Stewart	Bergnaum	ardith@denesikkrajcik.org
Lazaro	O'Hara	newell.kovacek@thiel.net
Collin	Effertz	miles@berge.info
Danial	Rodriguez	leonie@gleasonkunze.com
Carrie	Satterfield	fanny.yundt@heidenreichwatsica.biz
Brady	Labadie	bridget_cremin@adams.name
Cary	Kuhn	alyon@kreigerconroy.com
Daphnee	Oberbrunner	bryana.donnelly@konopelski.org
Bruce	Watsica	ruthie@osinskiokuneva.com
Louisa	Sauer	chanel@effertz.net
Lemuel	Streich	jaeden_grady@kuhn.name
Yvette	Considine	shyanne.pouros@deckow.info
Cindy	O'Keefe	geraldine@reichertsipes.biz
Ewald	Lynch	benton@douglas.org
Nicole	Will	albina.bogisich@robel.com
Breanna	Sawayn	eduardo.collier@emard.com
Roosevelt	Ritchie	ricardo@konopelskiziemann.net
Clementina	Kessler	matt.balistreri@jakubowski.biz
Marge	Koch	eva_wilderman@hettinger.biz
Sigmund	McGlynn	leta.reichert@zemlak.net
Marquis	Brown	lola@cruickshankkunze.biz
Nicola	Labadie	merl_hudson@dibberthintz.biz
Bethel	Stoltenberg	jude_hand@torp.com
Jeanne	Greenfelder	taylor@leuschke.info
Carole	Ritchie	daren@nolanmann.name
Sister	Dietrich	filomena@zboncakveum.info
Tanya	Turner	kailyn@harris.info
Birdie	Wisozk	chanelle@coleschaden.info
Katelyn	Morar	clinton@steubermclaughlin.info
Hanna	Rippin	alyson.jacobson@collier.org
Walter	Blick	sherwood@hellerfadel.net
Marta	Sawayn	brown@weber.net
Earlene	Lemke	cecilia@macejkovic.info
Armando	Heller	pearlie_dare@reillygleason.name
Seamus	Emard	claudia_harris@graham.info
Julianne	Boyle	jackson@schaeferfunk.org
Fred	McLaughlin	jerry@kohler.info
Annette	Mertz	filomena@roobernser.org
Gina	Rippin	destinee.robel@sawayn.net
Lavada	Gerlach	mervin_hirthe@bins.com
Marcia	Strosin	wilhelmine.gottlieb@towne.com
Ava	VonRueden	reina@gerhold.com
Mallie	Smitham	keira@hirthe.org
Elda	Larson	saul@muellerchamplin.org
Toney	Renner	mertie_frami@turner.biz
Travis	Rempel	dock@jenkins.info
Jaclyn	Schinner	skylar@doylestiedemann.net
Tom	Wolf	verna_schumm@leffler.info
Janick	Koelpin	edison@fritschlittel.net
Mozelle	Muller	ciara.gerhold@vandervort.biz
Lexie	Doyle	emma@brownklein.net
Ona	Stark	gaetano@conroy.com
Willow	Homenick	alexandra@cremin.com
Halie	Price	grover@hamillkohler.biz
Leora	Krajcik	reymundo@gleason.name
Ford	Bergnaum	velma_beatty@gibson.biz
Allie	Kirlin	elsa@borerprohaska.org
Betty	Rau	idell.ohara@hirtheschroeder.org
Bethany	Schroeder	rigoberto_johns@brekketorphy.com
Reilly	Zemlak	sandrine_feil@bernier.biz
Kayden	Stroman	tatum.swaniawski@steuber.net
Sonya	Zboncak	janick.lang@kuhic.info
Vince	Lesch	wilfred.dach@feeneyernser.net
Mathilde	Lubowitz	paolo@daughertyfisher.biz
Emelia	Friesen	raheem_dibbert@towneullrich.biz
Arno	Pollich	brooks.kshlerin@jacobson.com
Melba	Schneider	mina@pagac.info
Anais	Heaney	barry.yundt@schmelermayert.com
Stephanie	Ebert	aunta_osinski@johnston.org
Jeff	Johns	frances@luettgenpfeffer.org
Earnest	Wisoky	laury.feil@rath.biz
Adelle	Kirlin	sylvan.reichel@jonesbogan.com
Deontae	Pagac	joey@ruecker.net
Peyton	Aufderhar	seth_ledner@hilpertluettgen.biz
Etha	Wisozk	maude_heathcote@oconner.com
Sandy	Bailey	nova@jewepfannerstill.biz
Jeremy	Baumbach	lucy_lueilwitz@gleason.net
D'angelo	Oberbrunner	emmy.fay@grimetoltenberg.name
Kayley	Bashirian	audra.mosciski@naderswift.info
Aaliyah	Boyle	hortense@okeefe.com
Gianni	Heller	layne.bashirian@armstrongkshlerin.org
Finn	Bradtke	barry@schaden.net
Walton	Labadie	antonietta@jerdewyman.org
Sabryna	Gerlach	sim@muller.name
Tanya	Ratke	amalia@fritsch.org
Roberta	Effertz	khalil_hintz@morietteprohaska.name
Marlene	Metz	cielo.wisozk@cristrunolfsdottir.com
Ned	Blick	leopold.witting@ullrichokeefe.org
Carissa	Mueller	deven_runolfon@larkin.org
Constance	Eichmann	lloyd@stromanorn.biz
Robert	Kshlerin	stanley.weber@sporer.info
Juliet	Koch	gielle_jakubowski@becker.name
Lea	Kuhic	ellie@bartellspinka.com
Johanna	Grimes	eldred@toy.name
Loraine	Flatley	dino_mayert@bartoletti.net
Caden	Berge	ashleigh@greenfelderrempel.info
Jalyn	Bode	fatima.lynch@labadie.name
Kristy	Barton	jailyn_kemmer@prosacco.com
Dayana	Satterfield	shawna_schamberger@wintheiser.com
Antonina	Emmerich	sandy@wolff.info
Queenie	Raynor	tamara_williamson@greenholt.name
Brain	Armstrong	katheryn@simonisgutmann.biz
Madilyn	Grimes	saige.metz@adams.org
Darrion	Jerde	ansel@mccullough.org
Haleigh	Jenkins	reyes.haley@hyatt.name
Demetrius	West	terrell_labadie@hackett.org
Kole	Koch	river@ullrich.com
Drew	Mills	itzel_marvin@bosco.org
Muriel	Fay	houston_nicolas@schiller.org
Emily	Torphy	carolina.ruel@casper.info
Garrick	Dach	kaleb_strosin@bartelladams.net
Triston	Ondricka	rogelio@littleward.info
Darius	Schinner	concepcion@sawaynterry.biz
Jada	Powlowski	howell@durganlowe.biz
Ahmed	Rath	asha.hettinger@ullrich.biz
Clotilde	Runte	annabel@larkin.biz
Sigmund	Stroman	keven_jewe@larson.name
Mae	Pacocha	nellie@schultzcronin.org
Kyleigh	Barrows	ransom@lesch.net
Noah	Price	stanford.dicki@wehner.org
Otha	Bechtelar	brielle@kuvalis.info
Blaise	Treutel	summer_kovacek@bosco.net
Jovanny	Huels	davon@predovic.com
Scarlett	Hane	sofia.berge@kirlin.net
Irwin	Wehner	franz_pacocha@ritchiemacejkovic.net
Pierre	Gutmann	chance@rutherford.info
Glenda	Satterfield	tanya@powlowskibechtelar.name
Edward	Olson	rubie@thompson.net
Shanon	Grady	lance_dietrich@schimmel.org
Timmothy	Renner	helena_frami@dietrichyost.biz
Gudrun	Wyman	nakia@blandarogahn.biz
Verner	Bogan	antonia_nikolaus@murazik.com
Lyda	Jacobi	pierre@weinatstrosin.name
Barbara	Runolfsdottir	jeika@miller.info
Isabell	Veum	judy@strackeankunding.name
Casper	Rempel	daron_douglas@swaniawski.org
Charity	Kessler	colten@kutch.com
Era	Hettinger	angus@prosaccooreilly.name
Mose	Ratke	brannon_oconner@schoenmorar.biz
Nasir	Fisher	brycen@maggio.biz
Jeffery	Steuber	lucile@mante.org
Amelie	Thompson	hector@ricehaley.com
Elenor	Nicolas	mattie@berge.net
Ezequiel	Kuphal	alisa@rau.net
Kenna	Abbott	amparo_feest@bechtelar.org
Vida	Rolfson	juana@schoencrooks.name
Icie	Simonis	amanda@cain.name
Kristin	McGlynn	fleta@rempel.biz
Amelia	Aufderhar	alfredo@waelchi.org
Genoveva	Fahey	albin@mannupton.org
Viola	Koelpin	raphaelle@durgankaulke.info
Henri	Kub	nico@pfannerstill.org
Fredy	Hilpert	lyla_terry@wolffbartoletti.com
Alfonso	Schimmel	ashlynn.cain@huelbuckridge.net
Geovany	Feeney	rachel_volkman@gerlach.info
Billy	Hermiston	rosanna_gleichner@kuhlman.info
Josue	Weimann	myles@nicolas.com
Kyleigh	Jenkins	josue@mills.biz
Justyn	Kris	enos_blanda@gusikowski.com
Chelsea	Rutherford	amara_dibbert@hills.com
Everett	Swaniawski	brianne@morar.com
Bethel	Beer	carson.glover@emard.com
Blaise	Mosciski	diana@greenholtkreiger.net
Imogene	Wintheiser	camille_ko@grimes.net
Perry	Smitham	royal@johnston.info
Troy	Rowe	kaleigh@torphy.net
Kellen	Lowe	gwen_lubowitz@becker.name
Johnathan	Funk	jazmin@brakuchiller.net
Keven	Monahan	nathan@blick.org
Rebekah	Kling	alison@ondricka.info
Jamar	Zboncak	brennon@schmitt.org
Ruthe	Reilly	eudora@wisokyhegmann.info
Faustino	Farrell	lizeth@homenick.biz
Asa	Klein	kelsi_hayes@wilderman.net
Adrain	Corkery	eliseo.bahringer@mccullough.com
Vada	Donnelly	rubie@christiansen.org
Madisyn	Dickinson	avery.littel@kreiger.net
Patience	Aufderhar	davin.senger@bednar.com
Elta	Mann	adell.hirthe@krajcik.com
Jayde	Funk	pierre@kuhlman.org
Mollie	Klocko	leon_maggio@cruickshank.biz
Damon	Tromp	myrtie_bergnaum@quitzon.biz
Aidan	Kuvalis	reba_ernser@herman.biz
Victoria	Stoltenberg	timmy@kling.org
Tremaine	Schiller	dina_becker@hartmannbashirian.biz
Antoinette	Turner	raymundo.towne@torphy.name
Jamaal	Rohan	imogene_rodriguez@will.info
Malinda	Prosacco	araceli.walker@goodwinyundt.name
Gerald	Champlin	june_roberts@quitzonstanton.name
Erick	Lang	juanita@nader.biz
Natalia	Batz	providenci@upton.com
Celestine	Willms	lauretta@hirthehoeger.org
Frank	Kuphal	christina@mayermacejkovic.com
Nina	O'Keefe	destinee.dietrich@skiles.name
Merle	Goyette	bobby.pouros@bartell.name
Dorris	Mann	shaina.hilll@schowalterschinner.net
Maybell	Jewess	lori.tillman@greenmarks.biz
Jerald	McDermott	freddie@welch.net
Haleigh	Sauer	ismael@kris.info
Chester	Effertz	donald@mueller.net
Velma	Walter	carole_bahringer@stokes.biz
Norberto	Schultz	montana_romaguera@quigley.biz
Holden	Morar	flavie.grady@beer.net
Zackary	Bailey	ella@mraz.info
Andreane	Bosco	kenya@doylekertzmann.net
Omari	Gibson	stephan_dach@yost.biz
Brooks	Harris	collin_fadel@konopelski.info
Marta	Roberts	marcos@oconner.info
Rusty	Kessler	garry@goodwin.com
Nina	Hane	rosalyn@hahnwiza.info
Keyshawn	Bashirian	daniela.satterfield@pollichbogisich.info
Felipa	Thiel	hosea@shields.org
Cecil	Gottlieb	kennedi_renner@cainrohan.name
Leonie	Kovacek	malinda.koepp@davis.net
Brooke	Huel	lauriane@kuhlmancrooks.name
Vern	Schaden	chanel_runte@watersdubuque.biz
Prince	McGlynn	montana_rau@jerdecorkery.com
Jacklyn	Crona	edwin@deckow.name
Gayle	Mayert	meghan@cronin.net
Erik	Haag	kiarra_stark@hintz.info
Berneice	Daniel	dejon_lubowitz@zulaufjakubowski.info
Dessie	Bernier	ray.collins@blanda.biz
Joanny	Murazik	victor@mcclure.org
Kellen	O'Connell	cecelia_herzog@effertz.biz
Haleigh	Kutch	margaretta_franecki@walker.org
Waylon	Robel	eliseo_harber@nicolas.info
Avis	Marvin	rylan.mueller@mraz.com
Anjali	Rosenbaum	monserrate_wyman@lind.org
Gaston	Connelly	haie_jacobs@bogan.net
Kyler	Koepp	krystal@rice.name
Eula	Breitenberg	afton@braunbuckridge.org
Lilly	Jewess	kristoffer@pfeffer.info
Samson	Towne	caandra.zemlak@olson.net
Jordi	Treutel	verner_smitham@armstrong.com
Leora	Hettinger	itzel@kertzmannfranecki.biz
Sydnee	Upton	wilfredo_toy@sanford.info
Ollie	Renner	guie@bergnaumschamberger.com
Coleman	Steuber	joesph@thompsonhane.net
Keshawn	Metz	pearlie@walshgerhold.info
Natasha	Gusikowski	austin@pfannerstillparker.biz
Breanna	Orn	leland_toy@beatty.com
Lea	Renner	jayne@rippin.com
Brisa	Klein	reid@legrosjewe.name
Aleen	Friesen	otho_hills@rogahn.org
Wilburn	Lindgren	charles.wyman@greenholt.org
Caleb	Thiel	baron@howe.biz
Kara	O'Hara	dimitri_kohler@dach.net
Beatrice	Terry	alicia.lockman@wilderman.biz
Agustin	Wyman	tania.hackett@moen.name
Marietta	Altenwerth	brittany@denesik.com
Lesley	Kilback	consuelo_wiegand@boehm.org
Aimee	Davis	floy@rippin.name
Sheldon	Hintz	clare.vonrueden@bogisich.biz
Sheldon	Kling	sarah@corwin.name
Charlie	Abbott	jacky@gislasontromp.com
Wilbert	Wunsch	ned_marquardt@mohr.info
Eduardo	Legros	rosanna.grady@strackebuckridge.name
Jamar	Hackett	rahsaan@damore.name
Sabrina	Sipes	gaetano@ankunding.net
Gladyce	Powlowski	bettye@johnston.com
Bernadette	Kertzmann	newton_kemmer@waters.com
Tess	Sawayn	maymie@starkschroeder.org
Otto	Beatty	davion_pacocha@sipes.biz
Alison	Rice	jaleel@daniel.org
Candace	Batz	mary@schmeler.info
Adelbert	Jones	reba_fisher@okon.info
Dylan	Blanda	cyril.keler@franeckikunze.org
Nat	Beahan	keanu@torpstark.net
Josianne	Dicki	vada_windler@willwehner.name
Leda	Greenfelder	howell@powlowski.biz
Elvie	Swift	sterling_hudson@smithhowell.info
Lolita	Robel	micaela@greenfelder.info
Verona	Osinski	salma@wolff.net
Alysha	Bechtelar	marlee@oberbrunnerkub.com
Hailey	Barrows	humberto_adams@little.org
Chase	Schulist	malcolm@dietrichjast.info
Isaias	Bashirian	allen@bogan.biz
Reed	Douglas	werner_lueilwitz@jaskolski.com
Jimmie	Howell	jamil_harber@lindgren.name
Arjun	Johnson	milton@dickensernser.biz
Corene	Terry	raymond_stoltenberg@wehner.biz
Tyree	Treutel	kelley.sanford@durgan.com
Keon	Cormier	curtis@gislasonorn.net
Maida	Lockman	sidney.kuphal@balistrerigerhold.com
Devin	Rutherford	timothy@halvorson.com
Abbie	Murphy	delta@schiller.name
Darrel	Rau	josiah.rosenbaum@lesch.name
Delphia	Hessel	reba@schamberger.com
Ryder	Mills	emelie_cole@jast.com
Viviane	Lemke	willa@torphy.info
Sigrid	Leannon	vivien@shieldskeebler.info
Kayli	Vandervort	pearline.cruickshank@mayer.name
Jedidiah	Herman	nils@hermiston.org
Hershel	Dach	enola@parisian.info
Jeanette	Reinger	destiny_weinat@williamson.biz
Madie	Turner	maximilian_graham@haley.org
Trenton	Koepp	therese@wilkinson.name
Demarcus	Stoltenberg	javonte@okuneva.info
Maude	Rolfson	nickolas@romaguera.info
Felipa	VonRueden	eveline@johnsonhartmann.org
Piper	Stiedemann	josie.funk@torp.name
Darron	Reichel	kelvin.wilkinson@moore.com
Mitchel	Harris	isai_crist@trantow.net
Reilly	Walter	carli_blanda@hoppe.net
Alfonzo	Mills	zelma@mosciski.org
Cielo	Brekke	boris_bayer@stoltenbergbogan.info
Gina	Kuvalis	edgardo@johnsonblock.name
Rosalia	Greenfelder	felipe@satterfield.net
Tyrel	Smitham	alice.yundt@trompbernhard.biz
Taya	Kreiger	jerrell@harvey.info
Coralie	Bernier	freida.kreiger@kleincrona.net
Jerrell	Langworth	odea.hyatt@damorehayes.org
Elliott	Friesen	cyrus_gaylord@jaskolskibaumbach.biz
Christiana	Dach	maegan.oconnell@brown.biz
Edison	Walter	bobby_howe@cole.biz
Hank	Koelpin	chanelle@kunzeking.com
Kaitlyn	Dickens	jerrell@hirthe.com
Hyman	Runolfsson	fiona@kub.biz
Magali	Koch	duane@kulas.name
Ferne	Hammes	urban@crookslubowitz.name
Alverta	Stark	florence@conn.name
Penelope	Nader	marley@jerde.com
Mafalda	Medhurst	bell@robel.net
Alvah	Nicolas	giles.bartell@hane.name
Virginie	Stehr	hubert@swiftkub.net
Krystina	Ziemann	maryse@kunzedaniel.info
Lorenza	Lowe	lynn.volkman@runolfon.com
Raegan	Orn	morris.wintheiser@hartmannheel.info
Peter	Sauer	kareem@schulist.net
Darrion	Pacocha	elia@rau.biz
Kristoffer	Graham	piper@heidenreich.biz
Jennyfer	Hackett	vivien@turner.net
Jazmyne	Bechtelar	maribel@kirlinjewe.com
Alfonso	Bartoletti	brandt@ankunding.name
Laisha	Quigley	malinda_kuphal@champlinwintheiser.info
Carson	Mann	corrine@jerde.net
Kiana	Douglas	sidney_bauch@corwincrona.org
Coralie	Renner	stephany_dickens@gaylord.com
Otha	Turcotte	blaise@gusikowskibeier.name
Braden	Pfannerstill	zack@kuhlman.biz
Brandon	Stokes	shawna_hirthe@jakubowskitorp.org
Van	Langworth	chesley.hermann@langworth.net
Cathrine	Lesch	coleman.luettgen@ledner.org
Nels	Purdy	alexandro_gusikowski@wilkinson.org
Hilario	Keeling	rhoda_okeefe@little.com
Mara	Hermann	verda_smith@cartermoriette.net
Eliane	Wuckert	trent@greenfelder.name
Anastacio	Cronin	weldon@lowekoelpin.com
Pamela	Toy	alfredo@bode.org
Easton	Quitzon	hildegard@collins.net
Eleonore	Howe	delia@cormierwolff.name
Nella	Jakubowski	wendy@johns.biz
Monroe	Quigley	joanny@ricehowe.net
Annabel	West	ebba@turcottemacejkovic.org
Michel	Botsford	viva@blandabergstrom.com
Nickolas	Boyer	alvera.hackett@tillman.name
Amaya	Zemlak	turner@schaefer.net
Kirk	Gleason	oleta_wyman@armstrong.org
Constantin	Christiansen	vilma@hettinger.net
Aidan	Bailey	enola.kuphal@schultz.name
Micaela	Harvey	carroll.bayer@schneider.org
Kip	Kutch	claudia@mills.name
Cedrick	Nikolaus	malika@harber.org
Kaleigh	Satterfield	lillian_zulauf@langworth.biz
Brad	Schuppe	mckenzie_heaney@ratkebins.org
Camden	Beahan	emil_sipes@zemlak.info
Barbara	Wiegand	jerod@gutmannlind.info
Ardella	Mohr	kaylee_kub@kelerbode.org
Vidal	Skiles	rosalia.sawayn@mertz.biz
Olaf	VonRueden	jamison_witting@stark.net
Mckenzie	Witting	randi@klocko.name
Arlene	Towne	bernita@jones.name
Giovani	Rutherford	sherwood@anderson.name
Grady	Cartwright	kasey.treutel@dubuqueheathcote.info
Brady	McClure	ida.lowe@croninkoelpin.biz
Reyes	Purdy	bradley@torp.name
Kieran	Ritchie	dariana@kohlertorphy.info
Sabryna	O'Keefe	kellen@wisoky.info
John	Casper	emmy@borer.org
Alia	Leuschke	millie@turner.name
Yoshiko	Runolfsson	forrest@millsthiel.net
Leonora	Gorczany	brenda_kub@bins.name
Coty	Hegmann	ludie.stiedemann@lang.info
Rosemary	Sporer	enoch@keebler.net
Rodrigo	Kerluke	daryl_kohler@little.info
Amber	Bauch	magnolia.bahringer@okuneva.biz
Yvonne	Robel	elisa_sporer@senger.org
Robbie	Wisozk	lowell@krisvonrueden.org
Anderson	Graham	javon@bogisich.com
Elbert	White	valentina_shields@armstrong.biz
Nikki	Strosin	annabell.wunsch@ornpfannerstill.net
Vito	Tillman	april.wyman@wisozkkertzmann.name
Laurence	Lakin	viola@homenickgerlach.name
Derrick	DuBuque	major_nicolas@vonruedenshanahan.com
Ara	Botsford	waylon@davis.net
Euna	Rice	cleo.hayes@daniel.name
Amari	Considine	carolanne.schulist@gibson.net
Jaylon	Schmidt	robert@mcclureschultz.biz
Buddy	Lockman	candida@kaulkeheathcote.com
Josephine	Zieme	eliane@waters.org
Darron	Padberg	marianne.jacobson@hintz.name
Lillian	Johnston	triston@breitenberg.biz
Floyd	Okuneva	pierce@okeefelakin.org
Daron	Bogan	merlin@leuschkeweimann.org
Holly	Keebler	wilfrid@hand.biz
Elena	Weimann	abbie_koepp@hermiston.info
Haven	Upton	roosevelt@schmitt.name
Agustina	Fahey	elenora@will.name
Kamille	Steuber	jerald_emmerich@kirlin.info
Abigayle	Shields	judd@towne.net
Adela	Flatley	kaylah.ruel@abernathy.com
Terence	Blanda	alayna@koepp.org
Phyllis	Crist	nyasia@kuhlman.biz
Beth	Koepp	viva@zboncakbartoletti.com
Brain	Kuhlman	eloise@dicki.org
Carson	Marvin	jaron@harris.net
Hulda	Wolf	felicity@fritsch.info
Jackie	Gutmann	orion_fahey@boyer.net
Khalid	Rice	devante_kunze@wisoky.name
Estrella	Rippin	alvina@donnelly.info
Adela	Stiedemann	jacquelyn_brekke@botsford.net
Eric	Walsh	estella.pfannerstill@boyer.net
Brenden	VonRueden	doris@klingkautzer.biz
Lysanne	Labadie	meghan.brown@maggio.name
Marlon	Bergnaum	ruthe@johnstondach.biz
Lamont	Hermann	angelita.jewe@murray.biz
Pascale	Ullrich	yoshiko@fadel.org
Griffin	Bernhard	milton@berniergreen.net
Brody	Fadel	murphy@adamsjohns.com
Meghan	Langosh	maryjane.grady@ward.org
Enrico	Gibson	unique@witting.info
Opal	Batz	ollie@buckridge.name
Percy	Thompson	modesto@gorczany.name
Mariane	Hodkiewicz	luz@daugherty.org
Jules	Lehner	cali_harber@gusikowski.name
Camila	Swaniawski	monroe@west.com
Alyce	Greenfelder	annabelle_hickle@dach.org
Jasmin	Graham	afton_gaylord@bogan.com
Sophia	Murphy	clay_lehner@kunze.info
Amanda	Spinka	adrian_sanford@toy.com
Terrence	Jerde	earl_leffler@mclaughlin.info
Muhammad	Schulist	addison_boehm@abernathy.org
Lacy	Eichmann	ewald@ortizwatsica.biz
Katheryn	Koss	monica.olson@tromp.name
Mustafa	Rice	carmela_hermiston@nikolausmorar.com
Reina	Kovacek	meta@rolfson.net
Cristal	Block	neva@emardgaylord.name
Reece	Reichel	nikolas@wyman.net
Winnifred	Toy	dane@hilpert.biz
Joesph	Heaney	claria.wilderman@watsica.info
Tre	Kessler	susan@swift.biz
Katrine	D'Amore	elliot_schultz@lang.net
Clara	Beer	mckayla@kuhnstoltenberg.name
Mollie	Blanda	mitchel@crist.org
Ava	Marks	arnoldo_wiegand@beattymraz.net
Raquel	McLaughlin	daisha@daughertyjewe.org
Ignatius	Jakubowski	elwyn_labadie@haley.com
Devon	Romaguera	xzavier_veum@roberts.com
Madonna	Emard	vidal@bailey.com
Noemi	Mitchell	rodolfo@nader.info
Aubrey	Luettgen	tara@oreillytorp.info
Abigail	Padberg	burley.roberts@baumbach.net
Quinn	Crona	angie.kuphal@doyletremblay.com
Savannah	Hammes	vida_carroll@green.name
Gabrielle	Pollich	vincenzo.oconner@stracke.name
Bertram	Kutch	maureen@pfeffer.info
Sanford	Spinka	melba@smith.name
Darien	Blanda	samson@hintz.net
Golden	Batz	merritt.gerlach@schumm.org
Amiya	Macejkovic	jermaine.mckenzie@koelpin.org
Winfield	Gusikowski	rickie@keelinghills.info
Lavon	Hoeger	jedediah_bartoletti@stoltenbergebert.name
Tyrique	Howell	terrill@crist.info
Thora	Cronin	elaina.miller@greenholt.net
Frances	Dooley	eugene_west@stroman.info
Natasha	Schroeder	korbin@haag.com
Sandy	Schoen	prince@oreilly.com
Janice	Schimmel	royal_buckridge@vonrueden.name
Raegan	Schultz	jane_legros@crist.info
Judy	Veum	roma@parisian.biz
Jaylon	Dickens	noah.mccullough@darebreitenberg.name
Fay	Ziemann	ruthie_nader@willmsfranecki.com
Brandi	Christiansen	nestor@frami.name
Ryan	Wilderman	skyla@gleason.name
Arely	Eichmann	otilia@howell.com
Ora	Muller	alta@mullermckenzie.com
Brooke	Harber	kareem.king@oconnerschneider.info
Jazmyne	Murazik	rodrick@rauwuckert.net
Julius	Veum	vida@kerluke.net
Sabina	Moen	aaliyah@schinnergleason.net
Rubye	Oberbrunner	bradly@jakubowskirempel.info
Jordan	Harris	marietta_hayes@will.net
Hadley	Herzog	enola.kreiger@eichmann.info
Marlee	Prohaska	catharine.thompson@barton.name
Gabrielle	Considine	concepcion_morar@lakin.com
Lynn	Tromp	colt.goldner@maggio.com
Nora	Koepp	dortha@nienowgreen.info
Coleman	Breitenberg	wilfredo.botsford@jaskolski.name
Ferne	Veum	kristopher@volkman.biz
Julien	Osinski	tina@gaylord.info
Nichole	Paucek	adonis@kuhlman.name
Weston	Walker	jerrod@oreillymraz.org
Aurore	Balistreri	mac@sporer.com
Velma	Block	lela@bednarhalvorson.net
Madelyn	Skiles	earline@lind.biz
Tre	Yost	florence@klein.info
Andreanne	Parker	otho.sawayn@stanton.net
Regan	Shanahan	liliane@labadiegutmann.com
Justus	Waters	maybell@shanahan.org
Graham	Mills	amber@swift.info
Isabel	Flatley	maureen@skiles.net
Bruce	Breitenberg	elliot.hoeger@boylestokes.org
Jennifer	Waters	jana.orn@mckenziemitchell.net
Jaylen	Koepp	elmer@smitham.name
Jana	Kilback	humberto@ratkejast.biz
Domenick	Wisoky	scottie@hermanwuckert.com
Edgardo	Beahan	wilson.cormier@langosh.name
Orion	Dickens	merlin_walsh@wuckert.org
Carol	Bernhard	della_pollich@mante.biz
Trudie	Senger	quinten@daugherty.org
Tiana	Ledner	joanny_lind@schoen.biz
Darius	Bruen	noble@robel.org
Modesta	Pollich	ryder_goodwin@hickle.info
Kyler	Keeling	june@cormierhegmann.name
Marcella	Sauer	rae_murazik@zieme.info
Jaylan	White	shannon@hettinger.com
Tom	Davis	kathryn@bechtelar.name
Glenda	Rosenbaum	ania@wittingtremblay.name
Madalyn	Runolfsdottir	ole@reynolds.com
Bo	Legros	aimee@rice.name
Milton	Sawayn	cristal_corwin@schiller.net
Silas	Herzog	genevieve@steuberfriesen.net
Linnie	Hackett	kelly@sawaynwill.biz
Emelia	Schaefer	madaline@shieldsmraz.net
Tyler	Dietrich	gregorio@corwin.com
Justina	Cronin	gardner_leannon@gerhold.info
Cecelia	Marks	general.reynolds@herman.org
Ima	Willms	linnie.mitchell@aufderhar.biz
Murphy	Leannon	demetrius.langworth@hane.name
Luz	Shanahan	kale@cormier.net
Modesta	Emmerich	preston@toy.info
Bennett	Keeling	jacky@mertzprohaska.info
Theodora	Hayes	earline@brownkuhlman.com
Andre	Torp	elna_beatty@leuschkehackett.com
Leta	Tromp	eleanora.hamill@gulgowski.net
Fleta	Tromp	brielle@huel.net
Vicenta	Leannon	lynn_heller@langdurgan.net
Clay	Langworth	aurelio@lemke.org
Richard	Witting	kaelyn_lind@heaney.com
Isabella	Paucek	eliezer@crona.name
Trisha	Trantow	turner.romaguera@hansen.com
Bernadine	Renner	isabell@shieldsglover.com
Vicente	Bradtke	davin_berge@nikolausryan.biz
Kacie	Nicolas	madonna@jerde.name
Lera	Ratke	everardo_larson@hayes.info
Hudson	Batz	nat@macejkovicschaden.com
Alvis	Veum	kasandra.doyle@kutch.net
Tyrique	Zemlak	abbey@grimes.org
Abagail	Kautzer	milton@bernharddenesik.net
Joshuah	O'Conner	aubrey@balistreri.org
Palma	Towne	constance_berge@rogahn.org
Imelda	Lynch	elbert@muellerwehner.com
Bernardo	Doyle	arch@hilllroberts.biz
Alana	Fadel	nyasia_schowalter@adams.name
Monserrate	Pouros	noel@hermiston.info
Howell	Yost	cheyenne.schneider@denesik.biz
Ulises	Dickinson	earnest@pourosframi.net
Tito	Koelpin	cathrine@haneheel.biz
Jordi	Runolfsdottir	roberta_bins@kreiger.info
Berniece	Hills	alize.cremin@kaulke.info
Danial	Bode	alycia_stokes@doyle.info
Flossie	Durgan	vladimir.lubowitz@herman.name
Anahi	Wiza	bernhard@ziemebahringer.net
Olga	Lang	douglas.parker@roberts.com
Jayda	Koelpin	mara.schiller@kerluke.biz
Garrett	Klein	merl_lynch@schumm.com
Edward	Runolfsdottir	raquel@volkman.name
Magnus	Predovic	tara@bergnaumruecker.info
Ceasar	Wilkinson	viviane.veum@feest.name
Brooklyn	Prohaska	edwardo@purdy.info
Felton	West	heloise.hermann@watsica.name
Reed	Ferry	hilma.kuhlman@zulaufjakubowski.name
Maribel	Pacocha	landen@wisozk.org
Asia	Murazik	gerson.miller@upton.biz
Vito	Bergstrom	yesenia@lind.info
Elsie	Satterfield	timmothy_maggio@walker.net
Camila	Bogan	glen@wiza.biz
Andres	Reichert	harvey@lehnerpfannerstill.net
Lisandro	Kertzmann	ellsworth_jacobs@brown.net
Karen	Pacocha	lemuel.schuster@prosacco.biz
Lucy	Lehner	paxton.rosenbaum@nikolaus.net
Giovanni	Erdman	neil@oreilly.net
Miguel	Lynch	porter@mcglynnhermiston.biz
Madilyn	Johnston	garry@stehr.biz
Emie	Olson	betty@koch.com
Kelli	Hoppe	bethany.rogahn@moore.name
Shanny	Murphy	natalia_greenfelder@mccullough.net
Rachael	Bechtelar	rowena@schulistyost.org
Prudence	Littel	verna@macejkovicledner.info
Harold	Kohler	elna.hudson@feil.info
Edna	Halvorson	berniece@stoltenbergrempel.info
Justine	Herzog	prince@marquardt.biz
Elda	Kemmer	henderson_daniel@murazik.name
Yvonne	Kunze	rosa@parker.biz
Emily	Daugherty	jovani.hansen@pacocha.org
Abigale	DuBuque	sierra.larson@gislasonmann.biz
Bennie	Streich	millie@abshire.net
Nathanial	Weissnat	thora_lockman@ortiz.name
Hermina	Bailey	otilia@crist.info
Zachery	Lockman	maude.heathcote@schaden.net
Sylvan	Goyette	alyce_bergnaum@jacobs.biz
Dana	Hayes	ayana_schamberger@jacobs.info
Luna	Rath	lucile@fisher.net
Rocio	Lueilwitz	damien@jerdebeier.org
Dominique	Prohaska	alejandra_hamill@stracke.info
Cade	Nicolas	helena_mckenzie@monahan.name
Stanford	Gulgowski	dale@cronin.info
Vernie	Jerde	dewayne@robelsipes.biz
Daphnee	Ziemann	carolanne@hamillkuhlman.name
Judson	Spinka	alexis@howellwolf.info
Yvonne	Hane	urban.aufderhar@lehnerjast.biz
Raleigh	Graham	marta@lang.biz
Ivah	Huels	armando@bauch.com
Sydney	Fisher	monte_emard@bayerschuster.com
Octavia	Howell	aleandro@monahan.com
Abigale	Feil	israel@schamberger.info
Mariah	Wolff	delpha@schumm.biz
Dee	Beier	nathanial@haag.name
Kelley	Glover	harvey@gislason.name
Hal	Feil	richmond@boyerpagac.com
Marlin	Walter	lauretta@mantewindler.info
Melvin	Schulist	kobe_krajcik@maggio.net
Victoria	Fadel	pattie@beckerkunde.name
Wilbert	Crona	emmanuelle_mcclure@haley.net
Cruz	Becker	rozella.powlowski@green.com
Eleazar	Boyer	keon@lindmurray.org
Waylon	Funk	casandra.cartwright@wittingmorar.org
Nya	Hudson	caterina_upton@effertzchristiansen.info
Faye	Feil	isidro@lueilwitzdamore.net
Isabella	Kutch	queenie.hodkiewicz@mckenzie.info
Karelle	Friesen	sven@becker.info
Kylee	Luettgen	kraig.wolff@skiles.info
Ted	Hilll	mylene@aufderharhodkiewicz.name
Vito	Gutkowski	wilhelmine@okeefe.com
Joshuah	Miller	danny@ruel.net
Vita	Batz	nakia_larkin@wuckert.name
Albertha	Russel	euna_will@volkman.org
Manuel	Streich	carson@beierdooley.com
Deon	Treutel	pauline@hoegertromp.biz
Kellie	Grady	ronaldo@braun.name
Kali	Von	josh@kshlerinbartoletti.net
Tristin	Hickle	nigel@stark.org
Jerry	Parisian	emilia.brown@parker.name
Baylee	Thiel	otha_mcglynn@brekkecarter.biz
Arvel	Corwin	gail.johnson@bogan.org
Baron	Langworth	fannie_schultz@lesch.net
Marcelino	Muller	roma@olson.com
Art	Ankunding	zachary.connelly@rogahn.biz
Alan	Walsh	sigrid.oreilly@schmidt.biz
Noble	Jacobson	nona@emard.org
Felton	Marks	isidro_romaguera@stokesbernier.info
Lacy	Johnson	fredrick@schoen.name
Shea	Krajcik	llewellyn.price@orn.com
Agnes	Fay	brown.lakin@stiedemanncrist.com
Willy	Torphy	kamron.tromp@davisbernier.org
Fritz	Dietrich	otha@koch.info
Geovanny	Yundt	providenci_mraz@beahan.com
Webster	Mertz	marlin@howesatterfield.net
Giovanni	Auer	idella@larson.com
Emie	Weissnat	johanna@wunsch.info
Betty	Pouros	magali@gleasondeckow.name
Freeda	Daniel	orin@bosco.net
Shanny	Kling	janelle@schadenortiz.net
Jedidiah	Olson	darrick@medhurstmurazik.name
Lennie	Marquardt	colleen_dickinson@kirlinmoriette.net
Kaleigh	Kuphal	nola@glover.net
Clinton	Gerlach	rosella@goodwinnitzsche.info
Kip	Schoen	lottie.jakubowski@shanahan.com
Rashawn	Windler	lester@veumleffler.name
Cale	Anderson	giovanni.mcglynn@roberts.info
Ashleigh	Aufderhar	domenick@rathgerhold.info
Lavina	Auer	ethel.ernser@rennerjacobi.name
Alda	Schuppe	rosemary@rodriguezbeahan.info
Weldon	Hintz	annabel@beahan.com
Lyda	Murazik	sammie@wymancrona.biz
Jillian	Hayes	breana@mante.net
Aylin	Beier	julia@schneider.name
Tyrell	Gibson	eudora.buckridge@durgan.name
Eleazar	Champlin	randi.legros@wilderman.net
Godfrey	Williamson	jettie@whiteabernathy.biz
Dewitt	Gislason	kallie@robel.info
Adriel	Greenholt	germaine_kozey@starkprohaska.com
Toby	Luettgen	angeline.lindgren@rippin.net
Jeff	Schneider	audrey@mcculloughdonnelly.name
Stephan	Reichel	constantin@bartonruecker.org
Kenna	Parisian	bailee_jacobson@effertz.name
Cleveland	Brekke	janae.yundt@quitzon.org
Moriah	Borer	travis@gutmannkrajcik.org
Justyn	Graham	wendy@sawayn.biz
Jermey	Rowe	jazlyn@watsica.com
Tillman	Cole	torrey_emard@keler.net
Nina	Emard	juliet.reichert@wisozk.info
Nathan	Murphy	dagmar.kshlerin@thompsongraham.biz
Oma	Morar	jazmyne.wilderman@stanton.net
Hettie	Runolfsdottir	freeda.huel@langosh.com
Gus	Baumbach	caandre@kreiger.com
Dave	Kirlin	hattie@grimes.net
Maurine	Kohler	maverick@franeckilittle.biz
George	Kris	braulio_johnston@lemke.net
Lemuel	Jacobson	wiley_crooks@kilbackheaney.biz
Brook	Will	destin@heel.info
Korbin	Murphy	robbie@yundt.com
Jacky	Jakubowski	breana@fisher.info
Raymundo	Beier	cathryn.kirlin@mueller.name
Demond	Parisian	leonora@gaylord.com
Shad	Braun	chaim@kulas.com
Kenneth	Bayer	gideon@beerheathcote.org
Aletha	Harris	ivy.fadel@kirlinwillms.net
Rosa	Maggio	mckayla@mccullough.name
Fabian	Cremin	tatyana@predovic.net
Kassandra	Conroy	reuben@bashirian.biz
Sierra	Rippin	jacklyn@schoenanderson.name
Olaf	Miller	theodora@baumbachromaguera.com
Naomie	Runolfsdottir	jacques.kunze@kovacek.name
Ari	Wyman	walker_treutel@raynor.org
Giuseppe	Yost	austen@olson.org
Cathrine	Tillman	queen.metz@deckow.com
Ole	Gutmann	kenyon@gislasonhane.net
Winfield	Fritsch	jewel.mclaughlin@gulgowski.net
Creola	Hansen	kira@thompson.biz
Tanya	Bailey	ansel@abernathy.biz
Aileen	Heller	bell@hirthe.name
Pauline	Heathcote	pauline_skiles@reichel.org
Earline	Marquardt	dimitri@bruenmarvin.info
Kayden	Corkery	gunnar@schmelermedhurst.com
Aida	Parisian	clinton_heidenreich@funk.name
Adonis	Larson	abagail@littletowne.info
Ryley	Jerde	reanna_wiza@hicklebernier.info
Ines	Ernser	rosamond.howell@kiehn.com
Jameson	Kris	brennan_lehner@ruel.net
Beaulah	Murphy	herminia@nader.com
Toby	Greenholt	jonathon_olson@lemke.info
Jarvis	Shields	garnett.wilderman@auer.net
Mina	Ebert	george_bins@armstrong.info
Estefania	Waters	alexandria@schimmel.info
Jonathon	Terry	haven.gleason@cartwright.com
Piper	Hartmann	kaylin_reichel@glover.com
Alvah	Harris	alan_gerlach@nitzschepouros.net
Sammy	Lockman	sarai@schulistvon.net
Terrance	Marvin	cole_nikolaus@bechtelarjerde.info
Heather	Jacobs	brant@runolfonwilliamson.org
Angelina	Oberbrunner	yvonne@hayes.net
Aileen	Kreiger	kaandra.ernser@swaniawskistrosin.com
Herman	McClure	cody_ko@hermancole.net
Joel	Muller	trystan@erdmanfranecki.info
Glenda	Hudson	kyla.kertzmann@balistreri.net
Vilma	Wolff	violet_bogisich@altenwerthgrady.name
Imelda	Bashirian	bettie@stiedemann.info
Jon	Langworth	elya@greenholtbaumbach.info
Frederik	Murazik	astrid.lind@kilback.org
Rosalyn	Boehm	twila@dickens.com
Cary	Cassin	ahmad.jenkins@hilll.info
Collin	Medhurst	burdette@moore.org
Geoffrey	Carter	dedrick.cummings@fisher.biz
Rey	Wisozk	kaandra.thompson@littel.biz
Adonis	Botsford	ashleigh_gislason@langbeer.org
Earnest	Jewess	amina@berge.biz
Mohammed	Koelpin	jennie_mclaughlin@weinat.com
Jazmyne	Okuneva	delphia_okon@schaeferhuels.biz
Calista	Auer	nolan.brekke@goodwinbechtelar.com
Torrey	Christiansen	magdalen@abshireweimann.org
Romaine	Streich	rusty.jacobi@stehr.org
Tara	Olson	berenice@hoppe.name
Freida	Kirlin	jamaal@kirlinhirthe.org
Sharon	Stracke	kylee@hamill.info
Alec	Rutherford	isabell_wisoky@hodkiewicz.org
Kailey	Cruickshank	branson_kerluke@prosaccohahn.org
Mason	Schowalter	nayeli@mueller.net
Randal	Kohler	roberto@faheyschinner.biz
Jadyn	Raynor	rachelle@farrell.org
Vinnie	Rohan	juliana@homenickschroeder.name
Clemmie	Hoppe	bailey_pagac@grimes.com
Diamond	Von	jovany@tremblaygreenholt.name
Camron	Rippin	geovanni@trantow.com
Fae	Klocko	webster@bergnaumvolkman.org
Kayden	Hettinger	lexus@kingziemann.biz
Chyna	Stoltenberg	ike@swaniawski.name
Loy	Swift	cathy@okon.biz
Santino	Hirthe	pearline@runteberge.com
Ruby	Schimmel	mae.hyatt@wiza.com
Nedra	Olson	kirk@barton.com
Alysha	Zboncak	ike_kunde@parisian.com
Donavon	Baumbach	dimitri@mclaughlin.org
Christop	Lowe	greyson@schumm.name
Trudie	Pollich	effie_streich@ortizblock.com
Tamia	Gutmann	maddison@murrayhane.com
Aliya	Skiles	erna.kuhlman@paucek.info
Jeremie	Kunze	maude@ernsermante.net
Salvador	Corwin	addison.towne@lakin.name
Cecilia	Rolfson	jeremie.boyle@keler.name
Ruthie	Schowalter	orin@wiza.name
Carroll	Armstrong	mekhi@bergstromdurgan.info
Torrey	Wyman	connie@stanton.info
Domenico	Christiansen	torey@jacobi.org
Casimer	Gibson	kelli.stark@crona.biz
Isabel	Pagac	eladio@sipes.info
Cecile	Friesen	evelyn@connelly.info
Christine	Mueller	aimee@anderson.info
Daisy	Streich	kris_howell@lubowitz.biz
Ashley	Hahn	harmony_casper@grantthiel.org
Ethel	Price	joanny.doyle@sporer.info
Virginie	Kassulke	rachael@pacocha.name
Ford	Gerhold	ottilie@kirlin.info
Abby	King	chase_littel@gorczany.info
Meaghan	Dach	solon@botsford.biz
Clovis	Bergnaum	morton.aufderhar@beattygusikowski.biz
Rebeka	Konopelski	carolyn@ruecker.org
Hailey	Lebsack	skylar@jenkins.name
Adrienne	Fisher	kareem@parker.org
Uriah	Grant	evelyn.jacobi@moriette.biz
Naomi	Howell	shayne@prohaska.info
Adell	Reilly	nigel@moore.net
Lonny	Lang	irwin_rath@jacobi.com
Demetrius	Rice	wilfrid@jacobsonsenger.name
Russel	Harvey	saul@oconnellrunolfon.org
Vince	Treutel	anabel.schamberger@borerwillms.org
Zula	Hudson	kaya_hoeger@jerdeweber.net
Kacey	Hane	june.weber@powlowskidickens.biz
Kayla	Bashirian	piper.schmitt@turcotte.biz
Karlie	Hyatt	shana@nienowraynor.org
Alden	Crooks	fermin.ko@hagenes.org
Nathanial	Fay	dannie_gutmann@hirthe.biz
Brennon	Langworth	rod@boscoebert.info
Hannah	Lehner	rosetta_schumm@hane.net
Lionel	Raynor	dejah_hauck@gislason.info
Russ	Hahn	aniya_trantow@cronin.com
Dayna	Goldner	lillie@kshlerinabshire.org
Bella	Muller	mabelle.wisoky@towne.info
Fidel	Wyman	jailyn_pfannerstill@shanahan.name
Gregg	Prohaska	annabel@vonrueden.com
Demarcus	Runte	neoma@goyette.info
Talon	Kilback	angelita_smitham@hammes.net
Julien	Harvey	paul.parisian@strosin.net
Jamel	Olson	jimmie.bode@fay.info
Mandy	Olson	eugene@gibson.com
Jacklyn	Toy	william_ondricka@borer.info
Ayden	Kassulke	zane.hyatt@champlinosinski.info
Kiara	DuBuque	adrian_bergstrom@zulaufarmstrong.biz
Danielle	Hudson	otis@hackett.info
Sarah	Maggio	maritza@prohaskalesch.name
Jairo	Rippin	blaise@vandervort.org
Derrick	Little	vena@mclaughlin.com
Mike	Kuphal	horace@kuhlmanwitting.name
Delfina	Marks	efrain_yundt@miller.name
Ada	Heidenreich	aniyah.hermann@witting.info
Adaline	Fay	elfrieda_rodriguez@terry.name
Abbey	Tromp	kieran_gaylord@pagacsenger.org
Marcia	Krajcik	trinity.cole@nitzsche.com
Dusty	Schaefer	joshuah@dickens.org
Stanford	Johnston	rupert.mueller@vonrueden.info
Sunny	Daugherty	lavada.bruen@nienowoconner.com
Kari	Gerlach	ramon.rohan@emard.com
Camren	Hamill	reid_ryan@swiftwiegand.info
Dave	Wilderman	heber_steuber@abshire.info
Terry	Mann	cynthia@ritchie.org
Sydnee	Parker	sophia@erdman.biz
Lucio	Kessler	te@mertz.biz
Taya	Hirthe	nona.herzog@franecki.org
Margie	Kunze	barry@kutch.info
Reymundo	Von	brooks.heaney@schaeferswaniawski.com
Anika	Terry	kelley@emard.name
Nestor	Rippin	hallie_streich@farrell.biz
Santiago	Swaniawski	ezekiel@johns.name
Evalyn	Metz	easton_olson@batzcain.com
Chanelle	McCullough	justine.shields@bauch.info
Margot	Pfannerstill	hope_fisher@farrellkertzmann.info
Horacio	Marquardt	margie.hickle@funkhyatt.org
Jacklyn	Auer	ed@kunde.net
Georgiana	Rosenbaum	baron_johnston@kreiger.net
Jayden	Bergnaum	lukas@boyle.org
Rosina	Hauck	art@legros.org
Jonathan	Walker	lonzo_rowe@rolfson.info
Dejon	Goodwin	ariel@romaguera.net
Jerrod	Medhurst	pattie@pouros.name
Cali	Hagenes	drake@kutchoberbrunner.name
Cathy	Brown	derek@blockkub.com
Mandy	Mueller	emmitt_hoeger@schamberger.com
Alfredo	Rau	constance_veum@will.org
Lew	Ziemann	chaz_ebert@gorczany.name
Elwyn	Lehner	easter.mcdermott@eichmannrohan.org
Marcelina	Bruen	delta@gaylord.com
Nettie	Champlin	jackeline.wisoky@schultz.name
Keith	Goodwin	shania_marvin@breitenbergkoch.name
Leilani	Stark	dewayne@muller.com
Cecil	Lehner	emilie_jacobson@douglas.com
London	Nienow	korey.yost@veum.info
Johan	Stamm	reanna@damore.net
Shany	Von	kendall@stracke.info
Kirstin	Becker	claudie_brekke@oberbrunner.org
Marlene	Ruecker	roberta@bruen.net
Cullen	Mertz	santino@mcclure.biz
Mateo	Grant	samir.reynolds@langworth.info
Reyna	Rempel	gia@moriette.info
Sabryna	Huels	mary@monahankub.biz
Robyn	Hilll	presley@gleichner.net
Sydnie	Johnson	mariano@olson.com
Jayne	Hettinger	vincenzo.steuber@rolfson.info
Cicero	Kautzer	callie@kuhlman.com
Hiram	Braun	gregg.stokes@berge.info
Yadira	Wintheiser	dulce@rueckerbayer.net
Krista	Nikolaus	sid@bernierkling.name
Johnpaul	Nicolas	kendall@kulas.net
Reinhold	Champlin	katelynn@heidenreich.net
Victoria	Zboncak	blair@deckow.com
Adaline	Murphy	libbie@murazik.org
Jarred	Reinger	clint_legros@denesikgerlach.biz
Berniece	Luettgen	martina.gaylord@schmeler.com
Anabelle	Moore	bettye.tremblay@stoltenberg.net
Consuelo	O'Kon	charley_spencer@ortiz.org
Aimee	Eichmann	kylie_runolfon@larsonframi.net
Maddison	Shields	madie_macejkovic@schulist.net
Elise	Rogahn	donnell_graham@batzvandervort.com
Sabryna	Swift	giovani.homenick@olsonhowe.info
Lester	Balistreri	maria_hyatt@white.com
Sasha	Emard	kavon@zboncak.net
Cale	Ruecker	prudence.rogahn@homenick.info
Lauren	Kertzmann	clair_rohan@christiansenpfannerstill.biz
Elissa	Jacobi	filiberto@leannon.org
Billie	Hickle	bart@beatty.info
Shirley	Hirthe	bernard.lang@runte.info
Gage	Zieme	lucienne_kiehn@nienow.name
Merritt	Champlin	ruthe@oconnell.biz
Jasmin	Wisozk	thaddeus@cainziemann.name
Ida	Koelpin	teagan@howe.org
Gay	Vandervort	era_ortiz@blandabartell.biz
Jaylan	Goldner	guido@leffler.net
Niko	O'Connell	savannah.fahey@kilback.net
Nicholas	Pagac	marcel.quitzon@ornsimonis.net
Jerel	Yost	zoe_sanford@haagfritsch.com
Bethel	Sawayn	elia@satterfield.info
Kobe	Lesch	shayne@swaniawski.biz
Blanca	Mertz	anastacio_metz@blanda.org
Elisha	Baumbach	keely.wyman@gorczany.biz
Hazle	Grady	jett@lebsackmann.org
Marlon	Bergnaum	adolph@schoen.biz
Antonina	Schaefer	tommie@thiel.org
Allene	Ankunding	keyshawn@hettinger.org
Clifton	Stamm	velda@waelchi.info
Jamal	Gaylord	anya.weber@mayer.name
Brielle	O'Keefe	neha@wunschraynor.com
Antonia	Hartmann	jazmin.renner@haag.info
Maya	Cruickshank	connor@reicheltoy.org
Savanna	Breitenberg	fidel@ebert.info
Alva	Will	efren@pfannerstill.org
Deron	Satterfield	isidro_hickle@morar.biz
Macy	Skiles	levi_corwin@ruel.name
Trudie	Okuneva	catherine@hammes.name
Osbaldo	McCullough	gladyce@bradtke.info
Valentin	Torp	ova.reichert@sanford.net
Coby	Sauer	joseph@lowe.com
Friedrich	Roob	aidan_stokes@wymanroob.info
Paula	O'Reilly	alex@renner.biz
Jaydon	Larkin	mary_gottlieb@kris.name
Odie	Abernathy	alphonso@mannweimann.org
Kennedi	Monahan	eveline.mayert@jones.org
Cristal	Pacocha	claria@cronaheaney.name
Johnnie	Wunsch	claude@mcdermottgrant.com
Rosella	Cremin	constantin@vonrueden.biz
Sanford	Rowe	katelin@bashirian.com
Conrad	Block	kaelyn_stracke@wisozkgorczany.net
Willard	Mitchell	salvador.powlowski@stromangaylord.com
Aniya	Adams	rosario.wunsch@herzogveum.name
Quentin	Hirthe	elizabeth.witting@swift.com
Nico	Morissette	foster@johnson.com
Ashton	McClure	luella.bernier@zemlak.org
Dagmar	Keeling	keagan_romaguera@osinski.net
Evelyn	Yundt	estelle.goldner@morarkihn.name
Madonna	Kilback	berneice@adams.org
Trevion	Baumbach	colin.osinski@kuhickertzmann.biz
Nya	Kulas	ophelia@oconnerboyer.name
Timmy	Zieme	pierce_schuppe@sauerwehner.net
Hilton	Ziemann	jamarcus@volkman.info
Reina	Blanda	adrian@schneider.biz
Maci	Stanton	talia@yoststamm.biz
Doyle	Kuhlman	gerardo@huels.com
Cristopher	Heller	mohamed_brakus@leffler.biz
Eudora	Sipes	edd_hettinger@kihn.org
Luther	Franecki	rodolfo@orn.info
Martina	Hackett	braden.gleichner@gleichner.biz
Jerrod	Langworth	carolanne.swift@mcdermottkreiger.info
Lawrence	Wolf	zora.mraz@hermannwehner.info
Dylan	Schroeder	travis.kunde@vonhermann.biz
Joseph	Wiza	mazie.frami@ritchiehermann.info
Alexzander	Konopelski	jarod@mayerthackett.name
Milan	Hayes	keith_schumm@kuvalis.name
Ottilie	Glover	hobart_ortiz@upton.org
Osbaldo	Gislason	jalen_rau@bednaranderson.com
Jarrell	Huels	karine_harvey@blandaschoen.net
Aurelia	Davis	janice@yundtstracke.org
Wilson	O'Reilly	flo@maggio.org
Emmy	Price	peter.schowalter@osinskibosco.name
Kailee	Mayer	brendan@hermann.com
Sunny	Abshire	yolanda_rau@bartell.org
Arlene	Langworth	kasandra.cummerata@lynch.biz
Garth	Armstrong	aleia@simonis.name
Orion	Kilback	kade.crooks@krajciknader.name
Darrin	Bechtelar	lea@eichmannrunolfsdottir.info
Joyce	Bernhard	jamar.douglas@moen.info
Jacky	Hilpert	salma@krajcikferry.net
Michaela	Williamson	ardella@hoeger.org
Matilda	Larkin	johanna@haagwest.info
Brenda	Lowe	abraham.dietrich@oberbrunner.biz
Baby	Johnson	daren@little.org
Saige	Mraz	carley.rath@collins.net
Lurline	Paucek	marcella.kihn@hackett.net
Leann	Thiel	francisco@dare.org
Justyn	McKenzie	arianna_brekke@gorczany.com
Roy	Bruen	terrell@gerhold.biz
Adell	Langworth	silas@aufderhar.biz
Madisyn	Cummings	kathryn@hudson.biz
Eliseo	Sporer	andrew.ko@harber.info
Godfrey	Wehner	david_murazik@pouroseffertz.name
Kennedi	Prohaska	kolby_kuvalis@heller.info
Isaac	Stamm	devonte@waelchi.org
Johanna	Brakus	miguel@spinkaolson.net
Cecelia	O'Kon	orrin_quigley@trantow.net
Rossie	Herman	nina_frami@stehrlittle.biz
Kristofer	Reichel	lydia@rathspencer.info
Felton	Jewess	rhea.murray@mann.com
Marques	Mayert	lula@mcdermott.name
Edmund	Fay	johnny@oconner.biz
Conner	Schneider	eulalia@murphy.org
Delbert	Kuphal	devin@schamberger.biz
Camden	Kutch	euna.dubuque@jerdeschaefer.info
Brad	Cummings	gene_langosh@mcglynn.info
Ahmed	Cruickshank	francis_larkin@bins.com
Velma	Schmidt	hilton@ondricka.com
Ronny	Nienow	jacey@ziemann.org
Edgar	Mann	peggie@willstokes.biz
Freeman	Hauck	garett@kozey.net
Guido	Cummerata	kelsie.howe@ankunding.net
Bailee	Crona	jedidiah.pouros@hackett.info
Jace	Metz	caesar@quigleylubowitz.org
Sylvia	Hahn	reid@boyercremin.org
Maynard	Gleason	murphy@nitzsche.net
Assunta	Schamberger	anne_mante@rice.biz
Freeman	Ankunding	carolanne@wilkinson.net
Cristobal	Bahringer	dell_baumbach@littlemayer.net
Citlalli	Adams	cleora.weber@yostdurgan.org
Keon	Runolfsson	lindsay@dooley.com
Marcelina	Yundt	mariane.hackett@kritreich.com
Baylee	Jewess	buck@ebert.name
Norbert	Keebler	halle@schmitt.net
Ryleigh	Kassulke	delilah.dare@cruickshank.com
Ethan	Hessel	broderick@oconner.info
Nona	Padberg	chad.armstrong@wisoky.net
Rod	Runte	elmira.weinat@kautzer.info
Patrick	Robel	sydney@abernathyblock.org
Eriberto	Bernier	magdalena.murray@jast.net
Ari	Batz	vaughn_anderson@gerlach.biz
Odell	Connelly	ellsworth.heathcote@hickle.org
Jennie	Osinski	andres@bailey.com
Garret	Waelchi	connor@crooks.biz
Neva	Gerlach	manuela@kovacek.info
Telly	Langworth	reggie@bayer.name
Cornell	Pacocha	candido@witting.name
Raquel	Dooley	jake@koch.name
Jake	Sipes	valerie_luettgen@mills.org
Reyes	Fritsch	xander.stoltenberg@pagac.com
Aileen	Nolan	austen.witting@hagenes.com
Devyn	Volkman	marley.thompson@gulgowskicain.org
Rodrigo	Metz	shannon.oberbrunner@cummerata.name
Catherine	Wolf	rafaela@swaniawskidibbert.info
Ned	Kirlin	derek@hirthe.biz
Merritt	Grimes	hoyt.lubowitz@schaefer.info
Vance	Littel	german@blockratke.net
Laurine	Maggio	amari@grant.name
Ruben	Strosin	kattie@lemke.name
Devan	Bartoletti	chelsie@dubuque.com
Billy	Koepp	beaulah@prohaskastoltenberg.name
Morris	Gulgowski	je.upton@torp.org
Hilbert	Lindgren	michael.bednar@ankundingbechtelar.com
Hannah	Kling	austin_frami@leuschke.name
Ubaldo	Altenwerth	deborah.rowe@gloverdoyle.com
Darrin	Lueilwitz	hilbert@metz.org
Barbara	Willms	buster@pricefarrell.org
Kraig	Russel	kade_muller@torphy.com
Precious	Moore	delores@padberg.biz
Adela	Kilback	haleigh_tromp@goldner.org
Lula	Hane	hayley@paucek.org
Octavia	Reinger	clovis_huels@oharaklein.name
Dock	Rice	brandon.connelly@lehnerwalsh.info
Adonis	Mayert	emmalee_kihn@cummeratadavis.biz
Gerry	Hills	keanu_stokes@labadie.org
Kian	Schneider	lela_schowalter@armstrongbuckridge.name
Isaiah	Torp	julien@bradtkekris.name
Jade	Strosin	hallie_kulas@deckow.biz
Shaun	Wilkinson	isaac.okuneva@kuhicwaelchi.com
Nathanael	Wolf	rebeka.von@stamm.com
Amos	Dietrich	vivienne@gorczanypaucek.info
Haven	Grimes	amari@altenwerth.name
Andy	Ledner	jaida@pfannerstill.biz
Damaris	Dare	toni_schulist@deckow.org
Gerard	Kris	bertram.hane@hirthe.net
Roman	Reinger	laverna.hettinger@schoen.name
Martina	Lesch	adah@gulgowski.name
Ruthie	Johnson	kristofer@funk.info
Torey	Donnelly	dario@koelpin.biz
Twila	Schoen	cortez.jakubowski@dickinsonroob.info
Erling	Jacobi	rachael_barton@koelpin.name
Halle	Kiehn	scarlett@hettinger.biz
Jeff	Fahey	clark@predovic.com
Percy	Wilderman	adrian.zemlak@labadie.info
Velda	Zboncak	libbie.deckow@boyer.com
Jaiden	Gislason	marianne_nicolas@schaden.info
Lacy	Gleichner	raven@gusikowskihaley.org
Owen	Greenholt	edison.jerde@lubowitz.com
Rex	Jakubowski	mariela_hermiston@fisherkoelpin.net
Sammie	Jerde	sheila.stamm@fritsch.name
Bethel	Prosacco	durward_parker@wisoky.com
Jacklyn	Bergstrom	lesley@jacobi.biz
Theresia	Fahey	savion_reilly@wehnercole.net
Shany	Kunde	cruz_dibbert@mraz.net
Brent	Krajcik	eldred.kunde@herzogharris.com
Maia	Kihn	tatyana_spinka@greenchristiansen.name
Oliver	Howell	rhiannon_wintheiser@douglas.biz
Valentine	Altenwerth	travon.koepp@schmittmills.com
Kayla	Runolfsdottir	harold@binshaley.net
Dereck	Borer	guadalupe@bergnaum.com
Salvador	Johnson	noelia@mertzrippin.name
Jazmyn	Kuhlman	gage.brekke@sauerchristiansen.org
Leo	Moore	adonis@romaguera.com
Jessika	Reynolds	tanner@breitenbergweimann.info
Anissa	Legros	grady@emardhane.info
Sunny	Schaden	fabian.cremin@altenwerthrunte.info
Nigel	Spencer	wilton@ziemann.net
Iliana	Bosco	frederick_schamberger@rueckerharber.com
Herminia	Dibbert	merle_connelly@kilback.org
Ava	Reilly	boyd@mayert.name
Grayson	Raynor	demarcus_torphy@veumbatz.biz
Bobby	Hodkiewicz	terrance_goodwin@sporerlowe.org
Ernie	Larkin	taurean@gradyrunolfsdottir.org
Gustave	Gerlach	ara_waelchi@hagenes.biz
Jessie	Bernier	laurianne.pollich@dibbertreichert.info
Rachael	Nitzsche	destiney_goldner@bergecronin.org
Rosendo	Thompson	jayme@medhurst.biz
Else	Casper	genoveva@bergnaum.org
Marc	Volkman	margie@parisian.biz
Jakob	Boyer	jovani@moen.biz
Heidi	Zboncak	zelda.ledner@schroeder.org
Santos	Schulist	edgardo@daugherty.com
Burdette	Muller	elfrieda.kohler@lubowitz.info
Tristian	Schaden	dariana.gislason@dicki.biz
Omari	Cassin	vallie_bins@koepp.name
Justice	Barrows	harley@feeney.info
Eleanore	Morissette	dane@pacochalesch.info
Barry	Halvorson	connor@hermankub.org
Albert	Goldner	neil.schiller@coleparker.com
Josianne	Runte	houston_pollich@lehner.info
Amara	Rolfson	delilah_gorczany@schroeder.org
Kylee	Goldner	evalyn@tillman.name
Tatyana	Casper	taryn.mitchell@kreiger.name
Jaren	Wiza	francesca@litteldubuque.biz
Johanna	Schimmel	keaton.fay@wisoky.com
Mandy	Wolff	theresia@lowepacocha.biz
Ines	Schroeder	sylvester_schumm@denesikgrimes.biz
Carissa	Moore	elmore_jaskolski@greenfelderroob.net
Dulce	Ritchie	dusty.gislason@waelchiullrich.biz
Rodrick	Okuneva	beth_collins@rolfson.net
Precious	Schowalter	mario@dietrich.info
Kailee	Harvey	skylar.mraz@okon.org
Virgie	Feest	sierra.jaskolski@kris.org
Elizabeth	Hoppe	clemens.johnson@wolfbraun.info
Oren	Zulauf	lewis@mosciski.org
Stacy	Gerhold	dusty.gislason@douglasmclaughlin.com
Liliana	Berge	jalen@koelpin.com
Vada	Kunde	kyler.murazik@jast.name
Lisandro	Harber	lucie@ledner.biz
Johanna	Mitchell	bianka@dickenspaucek.com
Hattie	Hodkiewicz	scarlett@bauch.com
Cecil	Franecki	beth_willms@swaniawski.org
Verna	McClure	ashley_wehner@willms.com
Kennedy	Cormier	moie@davislubowitz.name
Rollin	O'Keefe	clay@becker.com
Jessica	Bergstrom	neva.turcotte@durgan.biz
Vada	Lindgren	annabell_romaguera@schmidt.net
Jeffery	Schultz	robbie@cartwright.net
Tremayne	Cassin	dianna@volkmanjewe.org
Lance	Waters	berry@corwin.org
Lonie	Boyer	haven.kuhlman@prosacco.name
Davin	Dach	emiliano@kuhic.info
Tavares	Feeney	rick@feest.info
Xander	Strosin	ursula@rowejohns.net
Meggie	Gaylord	liliane.borer@hodkiewicz.info
Nolan	Friesen	heloise@erdman.biz
Samanta	Osinski	oleta.casper@deckowmann.org
Laverna	Casper	emiliano.goyette@bergekeeling.org
Marjolaine	Medhurst	jennie.considine@flatley.biz
Raphaelle	Christiansen	freddie_kling@upton.name
Fiona	Cummings	gregoria@yundt.info
